name,ipeds_id,status,url,fips,enrollment_fulltime,status_merge,employment_fulltime,ihe_fulltime_population
Horizon University,457226,Already an online institution,https://www.horizonuniversity.edu/category/news/,18097,0,Primarily Online,8,8
Shiloh University,480499,Already an online institution,https://www.shilohuniversity.edu/,19183,9,Primarily Online,14,23
Maine College of Health Professions,161022,Already an online institution,https://www.mchp.edu/,23001,48,Primarily Online,28,76
Purdue University Global-St. Louis,490771,Already an online institution,https://www.purdueglobal.edu/academic-support/covid-19-faq/,29189,48,Primarily Online,0,48
Purdue University Global-Milwaukee,489788,Already an online institution,https://www.purdueglobal.edu/campus-locations/midwest/,55079,62,Primarily Online,0,62
City Vision University,457697,Already an online institution,https://www.nonprofitcovid19.org/,29095,71,Primarily Online,13,84
Purdue University Global-Lewiston,160940,Already an online institution,https://www.purdueglobal.edu/campus-locations/northeast/,23001,105,Primarily Online,0,105
Purdue University Global-Lincoln,181242,Already an online institution,https://www.purdueglobal.edu/academic-support/covid-19-faq/,31109,109,Primarily Online,0,109
Purdue University Global-Hagerstown,162681,Already an online institution,https://www.purdueglobal.edu/academic-support/covid-19-faq/,24043,135,Primarily Online,0,135
Homestead Schools,457086,Already an online institution,http://homesteadschools.net/wp-content/uploads/2020/03/Covid-Updates.pdf,06037,143,Primarily Online,19,162
Purdue University Global-Augusta,480064,Already an online institution,https://www.purdueglobal.edu/campus-locations/northeast/,23011,158,Primarily Online,0,158
Purdue University Global-Cedar Rapids,153418,Already an online institution,https://www.purdueglobal.edu/campus-locations/midwest/,19113,226,Primarily Online,0,226
Midwives College of Utah,480985,Already an online institution,https://www.midwifery.edu/covid-19/,49035,260,Primarily Online,25,285
Amridge University,100690,Already an online institution,http://www.amridgeuniversity.edu/coronavirus/,01101,295,Primarily Online,73,368
Charter Oak State College,128780,Already an online institution,https://www.charteroak.edu/updates/,09003,303,Primarily Online,148,451
Helms College,481155,Already an online institution,https://helms.edu/landing/,13021,304,Primarily Online,36,340
Purdue University Global-Des Moines,367024,Already an online institution,https://www.purdueglobal.edu/campus-locations/midwest/,19153,318,Primarily Online,0,318
Johnson & Wales University-Online,460349,Already an online institution,https://online.jwu.edu/?_ga=2.244666885.1432107725.1502198571-1382828486.1499961993,44007,405,Primarily Online,151,556
Los Angeles Pacific University,474863,Already an online institution,https://www.lapu.edu/lapucares/,06037,1003,Primarily Online,158,1161
University of Florida-Online,484473,Already an online institution,https://coronavirus.ufl.edu/,12001,1519,Primarily Online,84,1603
Brandman University,262086,Already an online institution,https://www.brandman.edu/news-and-events/news/coronavirus-information,06059,3245,Primarily Online,814,4059
Purdue University Global-Davenport,260901,Already an online institution,https://www.purdueglobal.edu/campus-locations/midwest/,19163,7274,Primarily Online,0,7274
Indiana Wesleyan University-National & Global,488679,Already an online institution,https://www.indwes.edu/covid19,18053,9330,Primarily Online,804,10134
University of Maryland-University College,163204,Already an online institution,https://www.umgc.edu/news/announcements/coronavirus.cfm,24033,9704,Primarily Online,2809,12513
Independence University,465812,Already an online institution,https://www.independence.edu/,49035,10095,Primarily Online,476,10571
Western Governors University,433387,Already an online institution,https://www.wgu.edu/about/covid-19.html,49035,121437,Primarily Online,5781,127218
Alaska Bible College,102580,Fully in person,http://www.akbible.edu/academics/class-schedule/,02170,32,Primarily In Person,14,46
Rosedale Bible College,439899,Fully in person,https://rosedale.edu/covid19/,39097,34,Primarily In Person,15,49
International Baptist College and Seminary,436614,Fully in person,https://ibcs.edu/event/this-weeks-update-covid-19-response/,04013,43,Primarily In Person,21,64
Wave Leadership College,486594,Fully in person,https://mailchi.mp/wavecollege/covid-19,51810,47,Primarily In Person,13,60
Las Vegas College,182148,Fully in person,https://lvcollege.edu/dear-new-and-prospective-students/?,32003,49,Primarily In Person,19,68
Grace College of Divinity,461528,Fully in person,https://gcd.edu/covid-19-news-updates/,37051,56,Primarily In Person,15,71
Saint John Vianney College Seminary,137272,Fully in person,https://www.sjvcs.edu/,12086,61,Primarily In Person,33,94
The Landing School,161208,Fully in person,https://www.landingschool.edu/covid19-response,23031,61,Primarily In Person,16,77
Clear Creek Baptist Bible College,156417,Fully in person,https://www.ccbbc.edu/covid-19,21013,72,Primarily In Person,31,103
Alaska Christian College,442523,Fully in person,https://alaskacc.edu/coronavirus/,02122,73,Primarily In Person,26,99
Thomas Edison State University,187046,Fully in person,https://www.tesu.edu/updates,34021,98,Primarily In Person,303,401
Chief Dull Knife College,180160,Fully in person,http://www.cdkc.edu/,30087,99,Primarily In Person,48,147
Saint Elizabeth College of Nursing,195702,Fully in person,https://www.secon.edu,36065,101,Primarily In Person,31,132
Hobe Sound Bible College,134510,Fully in person,https://hsbc.edu/home/coronavirus/,12085,107,Primarily In Person,32,139
Sisseton Wahpeton College,219408,Fully in person,https://www.swcollege.edu/,46109,110,Primarily In Person,55,165
Great Lakes Christian College,170091,Fully in person,https://www.glcc.edu/,26045,112,Primarily In Person,31,143
Criswell College,475608,Fully in person,https://www.criswell.edu/campus-response-to-coronavirus-covid-19/,48113,126,Primarily In Person,67,193
Kenrick Glennon Seminary,177816,Fully in person,https://kenrick.edu/seminary-closure-covid-19/,29189,130,Primarily In Person,47,177
Tillamook Bay Community College,420723,Fully in person,https://tillamookbaycc.edu/covid-19-information/,41057,138,Primarily In Person,57,195
Saint Joseph Seminary College,160409,Fully in person,https://www.sjasc.edu/coronavirus,22103,141,Primarily In Person,65,206
Appalachian Bible College,237136,Fully in person,https://abc.edu/coronavirus/,54081,162,Primarily In Person,58,220
Carver Career Center,430795,Fully in person,https://ccc.kana.k12.wv.us/,54039,170,Primarily In Person,19,189
Saint Charles Borromeo Seminary-Overbrook,216047,Fully in person,https://www.scs.edu/2020-covid-19-plan,42091,171,Primarily In Person,63,234
Crowley's Ridge College,106810,Fully in person,https://crc.edu/wp/coronavirus-statement/,05055,174,Primarily In Person,35,209
Dawson Community College,180151,Fully in person,https://www.dawson.edu/news-events/covid-19-updates.html,30021,179,Primarily In Person,58,237
American Academy of Art,142887,Fully in person,https://www.aaart.edu/about/corona-virus-information/,17031,181,Primarily In Person,58,239
Trinity Bible College and Graduate School,200484,Fully in person,https://www.trinitybiblecollege.edu/covid19,38021,192,Primarily In Person,60,252
Barclay College,155070,Fully in person,https://www.barclaycollege.edu/news/2020/04/18/barclay-college-covid-19-faq/,20097,197,Primarily In Person,44,241
Andrew College,138761,Fully in person,https://www.andrewcollege.edu/andrew-colleges-plan-to-manage-covid-19/#,13243,205,Primarily In Person,75,280
Judson College,101541,Fully in person,https://www.judson.edu/coronavirus/,01105,217,Primarily In Person,107,324
Orleans Technical College,214528,Fully in person,https://orleanstech.edu/news/back-in-business/,42101,220,Primarily In Person,52,272
Welch College,220206,Fully in person,https://welch.edu/coronavirus/,47165,242,Primarily In Person,72,314
Faith Baptist Bible College and Theological Seminary,153320,Fully in person,https://faith.edu/resources/coronavirus-updates/,19153,251,Primarily In Person,95,346
Nebraska College of Technical Agriculture,181765,Fully in person,https://ncta.unl.edu/coronavirus-covid-19,31063,275,Primarily In Person,47,322
Shorter College,107840,Fully in person,http://www.shortercollege.edu/course-schedule/,05119,331,Primarily In Person,63,394
College of the Ouachitas,107521,Fully in person,http://asutr.edu/covid,05059,338,Primarily In Person,136,474
J F Ingram State Technical College,101471,Fully in person,https://istc.edu/wp-content/uploads/2020/06/COVID-19-UPDATE.pdf,01051,349,Primarily In Person,124,473
Highlands College of Montana Tech,180081,Fully in person,https://www.mtech.edu/coronavirus/,30093,361,Primarily In Person,59,420
Ner Israel Rabbinical College,163532,Fully in person,https://nirc.edu/covid-19/,24005,398,Primarily In Person,56,454
Southern Arkansas University Tech,107992,Fully in person,https://www.sautech.edu/cv/,05013,404,Primarily In Person,123,527
Bethel College-North Newton,154749,Fully in person,https://www.bethelks.edu/coronavirus-information,20079,430,Primarily In Person,145,575
Presentation College,219295,Fully in person,https://www.presentation.edu/,46013,453,Primarily In Person,122,575
Williams Baptist University,107877,Fully in person,https://williamsbu.edu/coronavirus/,05075,454,Primarily In Person,118,572
Manor College,213774,Fully in person,https://manor.edu/coronavirusinformation/,42091,480,Primarily In Person,111,591
Cleveland University-Kansas City,177038,Fully in person,https://www.cleveland.edu/covid19/,20091,522,Primarily In Person,114,636
Maranatha Baptist University,239071,Fully in person,https://www.mbu.edu/updates/,55055,567,Primarily In Person,145,712
Oklahoma Wesleyan University,206835,Fully in person,https://www.okwu.edu/coronavirus/,40147,568,Primarily In Person,220,788
Iowa Wesleyan University,153621,Fully in person,https://www.iw.edu/covid-19/,19087,570,Primarily In Person,126,696
Mount Marty College,219198,Fully in person,https://www.mountmarty.edu/coronavirus/,46135,632,Primarily In Person,133,765
Central Christian College of Kansas,154855,Fully in person,https://www.centralchristian.edu/about/coronavirus/,20113,642,Primarily In Person,86,728
Webber International University,138293,Fully in person,https://www.webber.edu/news-updates/,12105,656,Primarily In Person,142,798
Kansas City Art Institute,177746,Fully in person,https://kcai.edu/emergency-communications/,29095,663,Primarily In Person,185,848
Ottawa University-Ottawa,155627,Fully in person,https://www.ottawa.edu/coronavirus/recentupdates,20059,672,Primarily In Person,165,837
Saint Mary-of-the-Woods College,152381,Fully in person,https://www.smwc.edu/offices-resources/offices/health-services-clinic/covid-19/,18167,679,Primarily In Person,203,882
Oakland City University,152099,Fully in person,https://www.oak.edu/coronavirus-covid-19,18051,685,Primarily In Person,299,984
Western Nebraska Community College,181817,Fully in person,https://www.wncc.edu/about-wncc/campus-safety/covid-19,31157,765,Primarily In Person,233,998
Johnson University,220473,Fully in person,https://johnsonu.edu/fall2020/,47093,780,Primarily In Person,196,976
Bethany College,154721,Fully in person,https://www.bethanylb.edu/coronavirus,20113,837,Primarily In Person,155,992
Mitchell Technical Institute,219189,Fully in person,https://www.mitchelltech.edu/coronavirus,46035,840,Primarily In Person,116,956
Dodge City Community College,154998,Fully in person,https://dc3.edu/students/health-wellness/,20057,841,Primarily In Person,214,1055
Huntingdon College,101435,Fully in person,https://www.huntingdon.edu/campus-life/health-wellness/covid-19/,01101,881,Primarily In Person,216,1097
Lamar State College-Port Arthur,226116,Fully in person,https://www.lamarpa.edu/General/Alerts/COVID-19,48245,900,Primarily In Person,176,1076
Atlanta Metropolitan State College,138901,Fully in person,https://www.atlm.edu/campus-life/coronavirus.aspx,13121,906,Primarily In Person,171,1077
Truett McConnell University,141237,Fully in person,https://truett.edu/news/archive/return-to-campus-announcement/,13311,937,Primarily In Person,199,1136
Wiregrass Georgia Technical College,141255,Fully in person,https://www.wiregrass.edu/covid-19,13185,946,Primarily In Person,345,1291
Cleveland Community College,198321,Fully in person,https://clevelandcc.edu/campus-updates/,37045,961,Primarily In Person,251,1212
Culver-Stockton College,177144,Fully in person,https://www.culver.edu/covid-19/,29111,965,Primarily In Person,193,1158
William Penn University,154590,Fully in person,https://www.wmpenn.edu/get-to-know-wpu/our-campus/coronavirus/,19123,1051,Primarily In Person,185,1236
Dunwoody College of Technology,175227,Fully in person,https://dunwoody.edu/campus-life/public-safety/covid19/,27053,1064,Primarily In Person,203,1267
MidAmerica Nazarene University,155520,Fully in person,https://www.mnu.edu/resources/reopen,20091,1069,Primarily In Person,340,1409
Hampden-Sydney College,232256,Fully in person,,51147,1070,Primarily In Person,355,1425
Ave Maria University,446048,Fully in person,https://www.avemaria.edu/coronavirus-covid-19-updates/,12021,1110,Primarily In Person,207,1317
Newman University,155335,Fully in person,https://newmanu.edu/campus-life/student-services/covid-19-updates-preparedness,20173,1123,Primarily In Person,280,1403
Coffeyville Community College,154925,Fully in person,https://www.coffeyville.edu/covid19/index,20125,1157,Primarily In Person,156,1313
St. Louis College of Pharmacy,179265,Fully in person,https://www.stlcop.edu/covid19/,29510,1158,Primarily In Person,246,1404
University of Sioux Falls,219383,Fully in person,https://www.usiouxfalls.edu/offices/campus-safety-and-security/coronavirus,46099,1158,Primarily In Person,240,1398
Ranken Technical College,178891,Fully in person,https://ranken.edu/health-advisory-covid-19-coronavirus-ranken/,29510,1210,Primarily In Person,207,1417
Dordt College,153250,Fully in person,https://www.dordt.edu/student-life/student-health-and-counseling-center/covid-19,19167,1343,Primarily In Person,257,1600
Freed-Hardeman University,220215,Fully in person,https://www.fhu.edu/campuslife/campussafety/coronavirus,47023,1364,Primarily In Person,322,1686
Lamar Institute of Technology,441760,Fully in person,https://www.lit.edu/news/855/communicable-diseases,48245,1365,Primarily In Person,193,1558
Northern State University,219259,Fully in person,https://www.northern.edu/coronavirus,46013,1383,Primarily In Person,377,1760
Buena Vista University,153001,Fully in person,https://www.bvu.edu/bv/health-services/coronavirus,19021,1405,Primarily In Person,412,1817
Grace College and Theological Seminary,150677,Fully in person,https://www.grace.edu/reopening-grace-college/covid-19/,18085,1490,Primarily In Person,207,1697
Casper College,240505,Fully in person,https://www.caspercollege.edu/coronavirus/,56025,1505,Primarily In Person,411,1916
Albion College,168546,Fully in person,https://www.albion.edu/student-life/health-services/covid-19,26025,1509,Primarily In Person,421,1930
Dakota State University,219082,Fully in person,https://dsu.edu/emergency-alerts/coronavirus-update.html,46079,1517,Primarily In Person,331,1848
Muskingum University,204264,Fully in person,https://www.muskingum.edu/returntocampus,39119,1521,Primarily In Person,312,1833
Montana Technological University,180416,Fully in person,https://www.mtech.edu/orediggerrx/index.html,30093,1552,Primarily In Person,357,1909
South Georgia State College,482699,Fully in person,http://www.sgsc.edu/alert.cms,13069,1580,Primarily In Person,222,1802
John Brown University,107141,Fully in person,https://www.jbu.edu/health-services/coronavirus/,05007,1630,Primarily In Person,367,1997
Drury University,177214,Fully in person,https://www.drury.edu/about/the-panther-plan-our-fall-2020-roadmap,29077,1631,Primarily In Person,364,1995
Three Rivers College,179645,Fully in person,https://www.trcc.edu/news/2020/03/0310.php,29023,1638,Primarily In Person,229,1867
Allegheny College,210669,Fully in person,https://sites.allegheny.edu/emergency/coronavirus/,42039,1724,Primarily In Person,427,2151
Northwood University,171492,Fully in person,https://www.northwood.edu/special-situations/covid-19,26111,1779,Primarily In Person,492,2271
West Georgia Technical College,139278,Fully in person,https://www.westgatech.edu/contact-us/coronavirus-information-and-resources/,13143,1803,Primarily In Person,483,2286
Oklahoma Baptist University,207403,Fully in person,https://www.okbu.edu/safety-resources/current-students.html,40125,1837,Primarily In Person,319,2156
Methodist University,198969,Fully in person,https://www.methodist.edu/coronavirus,37051,1857,Primarily In Person,468,2325
Black Hills State University,219046,Fully in person,https://www.bhsu.edu/About-BHSU/Safety/COVID-19-Coronavirus,46081,2062,Primarily In Person,405,2467
College of Coastal Georgia,139250,Fully in person,https://www.ccga.edu/page.cfm?p=2846,13127,2078,Primarily In Person,316,2394
University of Arkansas-Pulaski Technical College,107664,Fully in person,https://uaptc.edu/publichealth/,05119,2187,Primarily In Person,456,2643
Southern Adventist University,221661,Fully in person,https://www.southern.edu/connect/coronavirus.html,47065,2352,Primarily In Person,476,2828
Bob Jones University,217749,Fully in person,https://www.bju.edu/coronavirus/,45045,2357,Primarily In Person,667,3024
Embry-Riddle Aeronautical University-Prescott,104586,Fully in person,,04025,2637,Primarily In Person,468,3105
Wayne State College,181783,Fully in person,https://www.wsc.edu/covid19,31179,2733,Primarily In Person,408,3141
Niagara University,193973,Fully in person,https://www.niagara.edu/fall-2020-updates/,36063,3180,Primarily In Person,589,3769
Snow College,230597,Fully in person,https://www.snow.edu/offices/safety/coronavirus/index.html,49039,3226,Primarily In Person,446,3672
Lee University,220613,Fully in person,http://www.leeuniversity.edu/coronavirus/,47011,3975,Primarily In Person,720,4695
Embry-Riddle Aeronautical University-Worldwide,426314,Fully in person,https://erau.edu/coronavirus,12127,4265,Primarily In Person,643,4908
Columbia College,177065,Fully in person,https://www.columbiasc.edu/about/covid-19-updates,29019,4568,Primarily In Person,850,5418
University of West Alabama,101587,Fully in person,https://www.uwa.edu/coronavirus,01119,4755,Primarily In Person,492,5247
High Point University,198695,Fully in person,http://www.highpoint.edu/studenthealth/health-hub,37081,5045,Primarily In Person,958,6003
Bellevue University,180814,Fully in person,https://covid-19.bellevue.edu/,31153,5586,Primarily In Person,708,6294
Embry-Riddle Aeronautical University-Daytona Beach,133553,Fully in person,https://erau.edu/coronavirus,12127,6133,Primarily In Person,1403,7536
Mercer University,140447,Fully in person,https://www.mercer.edu/coronavirus/covid-19-fall-plans/,13021,7102,Primarily In Person,1686,8788
American Academy McAllister Institute of Funeral Service,188687,"Fully online, at least some students allowed on campus",https://funeraleducation.org/2020/07/09/3018/,36061,61,Primarily Online,26,87
American Baptist College,219505,"Fully online, at least some students allowed on campus",https://abcnash.edu/covid19/,47037,98,Primarily Online,31,129
Eastern West Virginia Community and Technical College,438708,"Fully online, at least some students allowed on campus",https://www.easternwv.edu/about-eastern/coronavirus,54031,133,Primarily Online,51,184
Simmons College of Kentucky,461759,"Fully online, at least some students allowed on campus",https://www.simmonscollegeky.edu/fall-reopening-announcement/,21111,158,Primarily Online,47,205
MacCormac College,146816,"Fully online, at least some students allowed on campus",https://www.maccormac.edu/important-campus-updates,17031,185,Primarily Online,35,220
Clinton College,217891,"Fully online, at least some students allowed on campus",https://www.clintoncollege.edu,45091,193,Primarily Online,57,250
Herzing University-Brookfield,459851,"Fully online, at least some students allowed on campus",https://www.herzing.edu/coronavirus,55133,206,Primarily Online,39,245
Sinte Gleska University,219374,"Fully online, at least some students allowed on campus",http://www.sintegleska.edu/sgucoronavirusinfo.html,46121,215,Primarily Online,125,340
Herzing University-Kenosha,459842,"Fully online, at least some students allowed on campus",https://www.herzing.edu/coronavirus,55059,234,Primarily Online,50,284
Herzing University-Kenner,433536,"Fully online, at least some students allowed on campus",https://www.herzing.edu/coronavirus,22051,255,Primarily Online,21,276
Southwestern Indian Polytechnic Institute,188216,"Fully online, at least some students allowed on campus",https://4.files.edl.io/abb9/06/30/20/191047-c9f9c361-d7aa-4746-b33c-6f834c794930.pdf,35001,319,Primarily Online,92,411
Arkansas Baptist College,106306,"Fully online, at least some students allowed on campus",https://www.arkansasbaptist.edu/fall2020/,05119,460,Primarily Online,94,554
St. John's College,163976,"Fully online, at least some students allowed on campus",https://www.sjc.edu/fall-plans,24003,514,Primarily Online,167,681
Life Pacific College,117104,"Fully online, at least some students allowed on campus",https://www.lifepacific.edu/tags/covid-19-updates,06037,530,Primarily Online,77,607
SUM Bible College and Theological Seminary,447953,"Fully online, at least some students allowed on campus",https://www.sum.edu/coronavirus-update-message-from-our-chancellor/,06017,534,Primarily Online,50,584
Wilberforce University,206491,"Fully online, at least some students allowed on campus",https://wilberforce.edu/coronavirus-covid-19/,39057,574,Primarily Online,94,668
CBD College,439367,"Fully online, at least some students allowed on campus",https://www.cbd.edu/2020/07/07/cbd-college-covid-19-update-as-of-7-07-2020/,06037,628,Primarily Online,78,706
Northern New Mexico College,188058,"Fully online, at least some students allowed on campus",https://nnmc.edu/covid19/,35039,632,Primarily Online,184,816
Lyon College,106342,"Fully online, at least some students allowed on campus",https://www.lyon.edu/coronavirus,05063,649,Primarily Online,200,849
Wilson College,217013,"Fully online, at least some students allowed on campus",https://www.wilson.edu/coronavirus-information,42055,701,Primarily Online,199,900
Menlo College,118693,"Fully online, at least some students allowed on campus",https://www.menlo.edu/student-life/health-wellness/coronavirus/july-2020-news-and-announcements/,06081,720,Primarily Online,146,866
Oglala Lakota College,219277,"Fully online, at least some students allowed on campus",http://www.olc.edu/coronavirus_home.htm,46102,721,Primarily Online,190,911
Holy Names University,115728,"Fully online, at least some students allowed on campus",https://www.hnu.edu/news/message-about-coronavirus-prevention-and-preparation-2/,06001,724,Primarily Online,224,948
Le Moyne-Owen College,220604,"Fully online, at least some students allowed on campus",https://www.loc.edu/about/covid-19/,47157,761,Primarily Online,149,910
Southern Wesleyan University,217776,"Fully online, at least some students allowed on campus",https://www.swu.edu/ready/,45077,820,Primarily Online,219,1039
Harvey Mudd College,115409,"Fully online, at least some students allowed on campus",https://www.hmc.edu/coronavirus-information/,06037,887,Primarily Online,327,1214
Cooper Union for the Advancement of Science and Art,190372,"Fully online, at least some students allowed on campus",http://cooper.edu/about/safety/coronavirus-covid-19,36061,899,Primarily Online,300,1199
Trinity Christian College,149505,"Fully online, at least some students allowed on campus",https://www.trnty.edu/coronavirus/,17031,944,Primarily Online,220,1164
Huston-Tillotson University,225575,"Fully online, at least some students allowed on campus",https://htu.edu/coronavirus-preparedness,48453,1035,Primarily Online,131,1166
National Park College,106980,"Fully online, at least some students allowed on campus",https://np.edu/about/campus-updates.aspx,05051,1114,Primarily Online,243,1357
South Suburban College,149365,"Fully online, at least some students allowed on campus",https://www.ssc.edu/news-events-information/covid19/,17031,1146,Primarily Online,376,1522
Coastal Bend College,223320,"Fully online, at least some students allowed on campus",http://coastalbend.edu/return/,48025,1202,Primarily Online,262,1464
Oglethorpe University,140696,"Fully online, at least some students allowed on campus",https://covid19.oglethorpe.edu/,13089,1212,Primarily Online,200,1412
Prairie State College,148007,"Fully online, at least some students allowed on campus",https://prairiestate.edu/covid19.aspx,17031,1310,Primarily Online,369,1679
Gallaudet University,131450,"Fully online, at least some students allowed on campus",https://www.gallaudet.edu/student-health-service/health-alerts/general-information-on-coronaviruses-from-the-cdc,11001,1341,Primarily Online,721,2062
Taft College,124113,"Fully online, at least some students allowed on campus",http://www.taftcollege.edu/cte/covid-19-resources-for-students/,06029,1399,Primarily Online,222,1621
Bishop State Community College,102030,"Fully online, at least some students allowed on campus",https://www.bishop.edu/news/coronavirus,01097,1425,Primarily Online,211,1636
Goucher College,162654,"Fully online, at least some students allowed on campus",https://www.goucher.edu/return-to-campus/,24005,1536,Primarily Online,486,2022
Baltimore City Community College,161864,"Fully online, at least some students allowed on campus",https://www.bccc.edu/coronavirus,24510,1547,Primarily Online,490,2037
Temple College,228608,"Fully online, at least some students allowed on campus",http://www.templejc.edu/safety/coronavirus/,48027,1593,Primarily Online,348,1941
Mountain View College,226930,"Fully online, at least some students allowed on campus",https://www.dcccd.edu/coronavirus/pages/default.aspx?utm_source=shortcut+url&utm_medium=redirect&utm_campaign=community&utm_term=coronavirus,48113,1594,Primarily Online,481,2075
Grinnell College,153384,"Fully online, at least some students allowed on campus",https://www.grinnell.edu/campus-life/health-wellness/coronavirus,19157,1679,Primarily Online,748,2427
Castleton University,230834,"Fully online, at least some students allowed on campus",https://www.castleton.edu/covid-19-coronavirus-updates/,50021,1703,Primarily Online,286,1989
California College of the Arts,110370,"Fully online, at least some students allowed on campus",https://portal.cca.edu/thriving/health-wellness/novel-coronavirus-covid19/fall-2020-semester-will-be-online/,06075,1710,Primarily Online,501,2211
Concordia University-Chicago,144351,"Fully online, at least some students allowed on campus",https://www.cuchicago.edu/general-information/covid-19-information/,17031,1713,Primarily Online,599,2312
North Lake College,227191,"Fully online, at least some students allowed on campus",https://www.dcccd.edu/coronavirus/pages/default.aspx?utm_source=shortcut+url&utm_medium=redirect&utm_campaign=community&utm_term=coronavirus,48113,1856,Primarily Online,536,2392
Drew University,184348,"Fully online, at least some students allowed on campus",http://www.drew.edu/stories/2020/05/23/drew-university-intends-to-begin-fall-semester-on-campus/,34027,1882,Primarily Online,449,2331
Rhodes College,221351,"Fully online, at least some students allowed on campus",,47157,2014,Primarily Online,527,2541
Colorado College,126678,"Fully online, at least some students allowed on campus",https://www.coloradocollege.edu/other/coronavirus/,08041,2106,Primarily Online,900,3006
Mount Holyoke College,166939,"Fully online, at least some students allowed on campus",https://www.mtholyoke.edu/coronavirus,25015,2193,Primarily Online,936,3129
Oxnard College,120421,"Fully online, at least some students allowed on campus",https://www.vcccd.edu/news/oxnard-college-updates,06111,2208,Primarily Online,259,2467
California Institute of Technology,110404,"Fully online, at least some students allowed on campus",https://coronavirus.caltech.edu/,06037,2233,Primarily Online,3125,5358
Muhlenberg College,214175,"Fully online, at least some students allowed on campus",https://www.muhlenberg.edu/offices/healthcenter/coronavirus/,42077,2248,Primarily Online,632,2880
Barnard College,189097,"Fully online, at least some students allowed on campus",https://alert.barnard.edu/,36061,2519,Primarily Online,875,3394
Saint Peter's University,186432,"Fully online, at least some students allowed on campus",https://www.saintpeters.edu/?post_type=notification&p=13327,34017,2581,Primarily Online,429,3010
University of Puget Sound,236328,"Fully online, at least some students allowed on campus",https://www.pugetsound.edu/emergency/coronavirus-2020/,53053,2590,Primarily Online,667,3257
Lafayette College,213385,"Fully online, at least some students allowed on campus",https://covid19.lafayette.edu/,42095,2603,Primarily Online,870,3473
Florida Southern College,134079,"Fully online, at least some students allowed on campus",https://www.flsouthern.edu/news/recent/2020/general/coronavirus-updates-and-frequently-asked-questions.aspx,12105,2840,Primarily Online,640,3480
Brigham Young University-Hawaii,230047,"Fully online, at least some students allowed on campus",https://www.byuh.edu/covid19,15003,2868,Primarily Online,461,3329
College of the Holy Cross,166124,"Fully online, at least some students allowed on campus",https://www.holycross.edu/2019-novel-coronavirus-covid-19-information,25027,2913,Primarily Online,1108,4021
Fresno Pacific University,114813,"Fully online, at least some students allowed on campus",https://www.fresno.edu/coronavirus-covid-19-news-and-information,06019,2974,Primarily Online,596,3570
Simmons University,167783,"Fully online, at least some students allowed on campus",https://www.simmons.edu/coronavirus/undergraduate-fall-2020/faq,25025,3119,Primarily Online,861,3980
Washtenaw Community College,172617,"Fully online, at least some students allowed on campus",https://www.wccnet.edu/news/2020/2020-06-26-fall2020.php,26161,3171,Primarily Online,811,3982
Ohlone College,120290,"Fully online, at least some students allowed on campus",https://www.ohlone.edu/information-corona-virus,06001,3404,Primarily Online,423,3827
University of Portland,209825,"Fully online, at least some students allowed on campus",https://www.up.edu/coronavirus/index.html,41051,3815,Primarily Online,915,4730
Catholic University of America,131283,"Fully online, at least some students allowed on campus",https://communications.catholic.edu/coronavirus/index.html,11001,4257,Primarily Online,1517,5774
Loyola University Maryland,163046,"Fully online, at least some students allowed on campus",https://www.loyola.edu/about/coronavirus-update,24510,4271,Primarily Online,1057,5328
Berklee College of Music,164748,"Fully online, at least some students allowed on campus",,25025,5459,Primarily Online,1292,6751
Modesto Junior College,118976,"Fully online, at least some students allowed on campus",https://www.mjc.edu/news/coronavirus2020.php,06099,5630,Primarily Online,659,6289
Pepperdine University,121150,"Fully online, at least some students allowed on campus",https://emergency.pepperdine.edu/2020/07/22/a-message-from-president-gash-online-instruction-for-fall-semester/,06037,5645,Primarily Online,1760,7405
University of the Pacific,120883,"Fully online, at least some students allowed on campus",https://www.pacific.edu/campus-life/student-services/student-health-services/coronavirus-disease-covid-19.html?utm_source=promo&utm_medium=site&utm_campaign=Coronavirus-Information&utm_content=news,06077,5688,Primarily Online,1693,7381
SUNY Oneonta,196185,"Fully online, at least some students allowed on campus",https://suny.oneonta.edu/fall-2020-re-start-plan,36077,6069,Primarily Online,975,7044
Morgan State University,163453,"Fully online, at least some students allowed on campus",https://www.morgan.edu/coronavirus,24510,6821,Primarily Online,1729,8550
Azusa Pacific University,109785,"Fully online, at least some students allowed on campus",,06037,7194,Primarily Online,1528,8722
Bloomsburg University of Pennsylvania,211158,"Fully online, at least some students allowed on campus",https://www.bloomu.edu/coronavirus,42037,7836,Primarily Online,1026,8862
National University,119605,"Fully online, at least some students allowed on campus",https://www.nu.edu/studentservices/nu-wellness/coronavirus/,06073,8034,Primarily Online,1830,9864
Princeton University,186131,"Fully online, at least some students allowed on campus",https://www.princeton.edu/news/2020/07/06/princeton-announces-plan-fall-2020-guidelines-undergraduates-returning-campus,34021,8267,Primarily Online,6452,14719
CUNY Queensborough Community College,190673,"Fully online, at least some students allowed on campus",https://www.qcc.cuny.edu/coronavirus/contactus.html,36081,9232,Primarily Online,1338,10570
The New School,193654,"Fully online, at least some students allowed on campus",https://www.newschool.edu/coronavirus/,36061,9240,Primarily Online,2162,11402
University of Massachusetts-Boston,166638,"Fully online, at least some students allowed on campus",https://www.umb.edu/coronavirus,25025,11268,Primarily Online,1910,13178
Savannah College of Art and Design,140951,"Fully online, at least some students allowed on campus",,13051,11651,Primarily Online,1724,13375
CUNY Queens College,190664,"Fully online, at least some students allowed on campus",https://www.qc.cuny.edu/community/Coronavirus/Pages/Reopening-Guidelines.aspx,36081,12631,Primarily Online,1759,14390
Johns Hopkins University,162928,"Fully online, at least some students allowed on campus",https://covidinfo.jhu.edu/jhu-2020-planning/,24510,14600,Primarily Online,18087,32687
Loyola University Chicago,146719,"Fully online, at least some students allowed on campus",https://www.luc.edu/coronavirus/?utm_source=luchomebanner&utm_medium=web&utm_campaign=coronavirus,17031,14997,Primarily Online,2844,17841
Ultimate Medical Academy-Clearwater,441371,"Fully online, at least some students allowed on campus",https://www.ultimatemedical.edu/covid-19/,12103,17865,Primarily Online,2045,19910
DePaul University,144740,"Fully online, at least some students allowed on campus",https://resources.depaul.edu/coronavirus-covid-19-updates/Pages/default.aspx,17031,18185,Primarily Online,2690,20875
George Washington University,131469,"Fully online, at least some students allowed on campus",,11001,19099,Primarily Online,5739,24838
James Madison University,232423,"Fully online, at least some students allowed on campus",https://www.jmu.edu/stop-the-spread/index.shtml,51660,19914,Primarily Online,3453,23367
Harvard University,166027,"Fully online, at least some students allowed on campus",https://www.harvard.edu/coronavirus,25017,21006,Primarily Online,17978,38984
University of Pennsylvania,215062,"Fully online, at least some students allowed on campus",https://fall-2020-planning.upenn.edu,42101,21960,Primarily Online,18245,40205
California State University-Los Angeles,110592,"Fully online, at least some students allowed on campus",http://www.calstatela.edu/healthwatch,06037,23097,Primarily Online,2110,25207
University of North Carolina at Chapel Hill,199120,"Fully online, at least some students allowed on campus",https://carolinatogether.unc.edu/,37135,25220,Primarily Online,13730,38950
Columbia University in the City of New York,190150,"Fully online, at least some students allowed on campus",https://covid19.columbia.edu/,36061,26072,Primarily Online,19499,45571
North Carolina State University at Raleigh,199193,"Fully online, at least some students allowed on campus",https://www.ncsu.edu/coronavirus/,37183,28368,Primarily Online,9299,37667
Southern New Hampshire University,183026,"Fully online, at least some students allowed on campus",https://www.snhu.edu/about-us/newsroom/2020/03/snhu-response-to-the-coronavirus,33013,29447,Primarily Online,5321,34768
California State University-Fullerton,110565,"Fully online, at least some students allowed on campus",http://coronavirus.fullerton.edu/,06059,30332,Primarily Online,2964,33296
Catholic Distance University,475398,"Fully online, no students on campus",https://cdu.edu/,54037,11,Primarily Online,26,37
Yeshiva Ohr Naftoli,490504,"Fully online, no students on campus",https://yeshivaohrnaftoli.com,36071,18,Primarily Online,4,22
Crossroads Bible College,439613,"Fully online, no students on campus",http://www.cbshouston.edu/start-today/,48201,23,Primarily Online,0,23
Dell'Arte International School of Physical Theatre,113537,"Fully online, no students on campus",https://nowebsite.com,06023,30,Primarily Online,16,46
Pacific Oaks College,120768,"Fully online, no students on campus",https://www.pacificoaks.edu/covid19-updates/,06037,39,Primarily Online,176,215
Remington College-Little Rock Campus,438869,"Fully online, no students on campus",http://www.remingtoncollege.edu/covid-19/,05119,39,Primarily Online,7,46
Yeshiva Bais Aharon,490319,"Fully online, no students on campus",https://www.google.com/search?q=yeshiva+bais+aharon&oq=Yeshiva+Bais+Aharon&aqs=chrome.0.0j46.312j0j4&sourceid=chrome&ie=UTF-8,34029,41,Primarily Online,5,46
Mechon L'hoyroa,490328,"Fully online, no students on campus",https://mechonlhoyroa.com,36087,45,Primarily Online,7,52
Yeshivas Emek Hatorah,491765,"Fully online, no students on campus",https://yeshivasemekhatorah.com/,34025,46,Primarily Online,7,53
Grace Mission University,481058,"Fully online, no students on campus",https://nowebsiteavailable.com,06059,48,Primarily Online,20,68
Centra College of Nursing,232618,"Fully online, no students on campus",https://www.centrahealth.com/CCON,51680,59,Primarily Online,52,111
Yeshivas Be'er Yitzchok,451370,"Fully online, no students on campus",https://yeshivasbeeryitzchok.com/,34039,61,Primarily Online,6,67
Yeshiva Chemdas Hatorah,491622,"Fully online, no students on campus",https://yeshivachemdashatorah.com/,34029,63,Primarily Online,9,72
Yeshiva Gedolah Tiferes Boruch,491613,"Fully online, no students on campus",https://yeshivagedolahtiferesboruch.com/,34035,63,Primarily Online,6,69
Bais Medrash Mayan Hatorah,490513,"Fully online, no students on campus",https://www.baismedrashmayanhatorah.com/,34029,67,Primarily Online,10,77
Nazarene Bible College,127714,"Fully online, no students on campus",https://www.nbc.edu/,08041,69,Primarily Online,68,137
Carolina Christian College,199971,"Fully online, no students on campus",https://carolina.edu/coronavirus/,37067,70,Primarily Online,5,75
Trinity International University-Florida,135610,"Fully online, no students on campus",https://florida.tiu.edu/student-services/coronavirus-covid-19-updates-and-resources/,12086,72,Primarily Online,25,97
Veritas Baptist College,482228,"Fully online, no students on campus",https://vbc.edu/,18029,77,Primarily Online,19,96
Cankdeska Cikana Community College,200208,"Fully online, no students on campus",http://www.littlehoop.edu/covidresponse.html,38005,78,Primarily Online,111,189
Urban College of Boston,429128,"Fully online, no students on campus",http://urbancollege.edu/coronavirus.aspx,25025,78,Primarily Online,44,122
Pomeroy College of Nursing at Crouse Hospital,190451,"Fully online, no students on campus",https://www.crouse.org/nursing/student-life/coronavirus/,36067,81,Primarily Online,28,109
Ilisagvik College,434584,"Fully online, no students on campus",https://www.ilisagvik.edu/update-coronavirus-disease-2019-covid-19/,02185,84,Primarily Online,85,169
Yeshiva Gedolah of Cliffwood,491710,"Fully online, no students on campus",https://yeshivagedolahcliffwood.com/,34025,84,Primarily Online,8,92
Phillips School of Nursing at Mount Sinai Beth Israel,189282,"Fully online, no students on campus",https://www.mountsinai.org/locations/beth-israel/pson,36061,89,Primarily Online,32,121
Southern California Seminary,117575,"Fully online, no students on campus",https://www.socalsem.edu/a-new-covid-19-update-from-southern-california-seminary/,06073,94,Primarily Online,27,121
Yeshiva Kollel Tifereth Elizer,491057,"Fully online, no students on campus",https://yeshivakolleltiferethelizer.com,36047,94,Primarily Online,15,109
Little Priest Tribal College,434016,"Fully online, no students on campus",https://littlepriest.edu/covid-19/,31173,95,Primarily Online,64,159
Yeshiva Shaar Ephraim,490276,"Fully online, no students on campus",http://shaarephraim.org,36087,109,Primarily Online,21,130
Bnos Zion Of Bobov Seminary,491446,"Fully online, no students on campus",https://bnoszionbobov.com/,36047,122,Primarily Online,10,132
Yeshiva Gedola Tiferes Yerachmiel,491914,"Fully online, no students on campus",https://www.google.com/search?q=yeshiva+gedola+tiferes+yerachmiel&oq=Yeshiva+Gedola+Tiferes+Yerachmiel&aqs=chrome.0.0.721j0j4&sourceid=chrome&ie=UTF-8,34029,128,Primarily Online,13,141
American Jewish University,116846,"Fully online, no students on campus",https://www.aju.edu/about-aju/covid-19-planning-and-preparation,06037,131,Primarily Online,117,248
Remington College-Honolulu Campus,372958,"Fully online, no students on campus",http://www.remingtoncollege.edu/honolulu-hawaii-colleges-career-schools,15003,131,Primarily Online,22,153
Yeshiva Gedolah Keren Hatorah,491640,"Fully online, no students on campus",https://yeshivagedolahkerenhatorah.com/,34029,147,Primarily Online,10,157
Hellenic College-Holy Cross Greek Orthodox School of Theology,166054,"Fully online, no students on campus",https://www.hchc.edu/news/,25021,149,Primarily Online,71,220
Commonwealth Institute of Funeral Service,366261,"Fully online, no students on campus",http://commonwealth.edu/,48201,152,Primarily Online,13,165
Beulah Heights University,139153,"Fully online, no students on campus",https://www.beulah.edu/president,13121,155,Primarily Online,63,218
Seminary Bnos Chaim,491817,"Fully online, no students on campus",https://www.google.com/search?ei=AEoJX7CKD9LdtAbcwbCYAQ&q=seminary+bnos+chain&oq=seminary+bnos+chain&gs_lcp=CgZwc3ktYWIQAzIECAAQDTIICAAQCBANEB4yCAgAEAgQDRAeOgQIABBHULooWLooYIIraABwAXgAgAHxAYgB8QGSAQMyLTGYAQCgAQGqAQdnd3Mtd2l6&sclient=psy-ab&ved=0ahUKEwiwiqnrt8TqAhXSLs0KHdwgDBMQ4dUDCAw&uact=5,34029,159,Primarily Online,11,170
Curtis Institute of Music,211893,"Fully online, no students on campus",https://www.curtis.edu/covid-19/,42101,171,Primarily Online,96,267
College of the Muscogee Nation,480967,"Fully online, no students on campus",https://cmn.edu/?s=covid,40111,181,Primarily Online,60,241
Associated Beth Rivkah Schools,188942,"Fully online, no students on campus",https://dhl.bethrivkah.edu/,36047,195,Primarily Online,20,215
The Chicago School of Professional Psychology at Los Angeles,455664,"Fully online, no students on campus",https://www.thechicagoschool.edu/covid19-updates/,06037,199,Primarily Online,81,280
Yeshivath Zichron Moshe,197744,"Fully online, no students on campus",https://yeshivathzichronmoshe.com,36105,215,Primarily Online,21,236
University of the West,449870,"Fully online, no students on campus",http://www.uwest.edu/covid-19/,06037,228,Primarily Online,66,294
Purdue University Global-Indianapolis,489779,"Fully online, no students on campus",https://www.purdueglobal.edu/academic-support/covid-19-faq/,18097,241,Primarily Online,1085,1326
St. Joseph's College of Nursing,195191,"Fully online, no students on campus",https://www.sjhcon.edu/upload/docs/College/covid_19_notice.pdf,36067,244,Primarily Online,41,285
Averett University-Non-Traditional Programs,449931,"Fully online, no students on campus",https://gps.averett.edu/,51590,248,Primarily Online,53,301
Herzing University-Birmingham,101365,"Fully online, no students on campus",https://www.herzing.edu/coronavirus,01073,271,Primarily Online,37,308
Trine University-Regional/Non-Traditional Campuses,414878,"Fully online, no students on campus",https://www.trine.edu/trine-strong/index.aspx,18003,289,Primarily Online,46,335
Peirce College,214883,"Fully online, no students on campus",https://www.peirce.edu/covid-19,42101,291,Primarily Online,153,444
Luna Community College,363633,"Fully online, no students on campus",https://luna.edu/coronavirus,35047,292,Primarily Online,139,431
Remington College-Mobile Campus,366535,"Fully online, no students on campus",https://www.remingtoncollege.edu/covid-19/,01097,313,Primarily Online,39,352
Mesivta Torah Vodaath Rabbinical Seminary,193052,"Fully online, no students on campus",http://independentrabbinicalcolleges.org/index.html,36047,318,Primarily Online,17,335
Remington College-Houston Southeast Campus,451857,"Fully online, no students on campus",https://www.remingtoncollege.edu/covid-19/,48201,324,Primarily Online,36,360
Remington College-Heathrow Campus,460783,"Fully online, no students on campus",https://www.remingtoncollege.edu/covid-19/,12117,325,Primarily Online,25,350
South Florida Bible College and Theological Seminary,366003,"Fully online, no students on campus",https://www.sfbc.edu/sfbc-health-alerts/,12011,331,Primarily Online,46,377
St. John's College,245652,"Fully online, no students on campus",https://www.sjc.edu/fall-planshttps://www.sjc.edu/fall-plans,35049,350,Primarily Online,146,496
Northwest Indian College,380377,"Fully online, no students on campus",https://www.nwic.edu/nwic-covid-19-update-07-31-2020/,53073,377,Primarily Online,166,543
Southeastern Technical College,368911,"Fully online, no students on campus",http://www.southeasterntech.edu/news/news-stc-coronavirus-update.php,13279,378,Primarily Online,173,551
Goddard College,230889,"Fully online, no students on campus",https://www.goddard.edu/goddard-college-coronavirus-update/,50023,408,Primarily Online,77,485
Paine College,140720,"Fully online, no students on campus",https://www.paine.edu/web/mycampus/covid-19,13245,432,Primarily Online,135,567
Soka University of America,399911,"Fully online, no students on campus",https://www.soka.edu/coronavirus-update,06059,442,Primarily Online,234,676
Remington College-North Houston Campus,445203,"Fully online, no students on campus",https://www.remingtoncollege.edu/covid-19/,48201,448,Primarily Online,38,486
Union Institute & University,206279,"Fully online, no students on campus",https://myunion.edu/,39061,461,Primarily Online,178,639
Bennett College,197993,"Fully online, no students on campus",https://www.bennett.edu/news/statement-coronavirus/,37081,463,Primarily Online,129,592
Remington College-Fort Worth Campus,377111,"Fully online, no students on campus",https://www.remingtoncollege.edu/covid-19/,48439,474,Primarily Online,47,521
Turtle Mountain Community College,200527,"Fully online, no students on campus",https://www.tm.edu/current_students/novel-coronavirus-covid-19-preparedness-and-response/,38079,479,Primarily Online,132,611
Voorhees College,218919,"Fully online, no students on campus",https://www.voorhees.edu/our-college/news-updates/emergency-updates-information,45009,480,Primarily Online,132,612
University of Providence,180258,"Fully online, no students on campus",https://www.uprovidence.edu/coronavirus/,30013,517,Primarily Online,190,707
Paul Quinn College,227429,"Fully online, no students on campus",https://pqc-edu.squarespace.com/covid19updates,48113,521,Primarily Online,73,594
Salem College,199607,"Fully online, no students on campus",https://www.salem.edu/COVID-19,37067,561,Primarily Online,160,721
Remington College-Cleveland Campus,375416,"Fully online, no students on campus",http://www.remingtoncollege.edu/covid-19/,39035,568,Primarily Online,52,620
Warren County Community College,245625,"Fully online, no students on campus",http://www.warren.edu/wccc-restart-plan/,34041,586,Primarily Online,76,662
Remington College-Memphis Campus,412599,"Fully online, no students on campus",https://www.remingtoncollege.edu/covid-19/,47157,611,Primarily Online,71,682
Morris College,218399,"Fully online, no students on campus",https://www.morris.edu/student-life/onward-upward-fall-2020-semester,45085,633,Primarily Online,170,803
Goldey-Beacom College,130989,"Fully online, no students on campus",https://www.gbc.edu/fall2020/PresidentialAddress.html,10003,680,Primarily Online,115,795
Haskell Indian Nations University,155140,"Fully online, no students on campus",https://www.haskell.edu/wp-content/uploads/2020/06/Haskell-Classes-Online-Fall-2020.pdf,20045,698,Primarily Online,143,841
Marymount California University,118541,"Fully online, no students on campus",https://www.marymountcalifornia.edu/campus-services/student-wellness-center/coronavirus-update/,06037,737,Primarily Online,122,859
Unity College,161572,"Fully online, no students on campus",https://unity.edu/covid-19/,23027,770,Primarily Online,238,1008
Remington College-Dallas Campus,223463,"Fully online, no students on campus",https://www.remingtoncollege.edu/covid-19/,48113,779,Primarily Online,55,834
Washington Adventist University,162210,"Fully online, no students on campus",https://www.wau.edu/virus/wau-covid-19-faq/,24031,812,Primarily Online,197,1009
Hallmark University,225201,"Fully online, no students on campus",https://hallmarkuniversity.edu/coronavirus/,48029,815,Primarily Online,128,943
Notre Dame de Namur University,120184,"Fully online, no students on campus",https://www.ndnu.edu/campus-life/health-services/corona-virus/,06081,822,Primarily Online,198,1020
Stella and Charles Guttman Community College,475565,"Fully online, no students on campus",https://guttman.cuny.edu/news/coronavirus-updates/,36061,848,Primarily Online,189,1037
Touro University Worldwide,459727,"Fully online, no students on campus",https://www.tuw.edu/,06059,865,Primarily Online,76,941
Cambridge College,165167,"Fully online, no students on campus",https://www.cambridgecollege.edu/covid-19-updates,25025,874,Primarily Online,214,1088
Wiley College,229887,"Fully online, no students on campus",https://www.wileyc.edu/pandemic-response/,48203,877,Primarily Online,175,1052
Granite State College,183257,"Fully online, no students on campus",https://www.granite.edu/coronavirus-info/,33013,903,Primarily Online,167,1070
Jarvis Christian College,225885,"Fully online, no students on campus",,48499,923,Primarily Online,140,1063
Pacific Union College,120865,"Fully online, no students on campus",https://www.puc.edu/news/coronavirus-updates-and-resources,06055,967,Primarily Online,210,1177
Agnes Scott College,138600,"Fully online, no students on campus",,13089,998,Primarily Online,365,1363
Texas College,228884,"Fully online, no students on campus",https://www.texascollege.edu/covid-19-information/,48423,1025,Primarily Online,137,1162
Pitzer College,121257,"Fully online, no students on campus",,06037,1050,Primarily Online,309,1359
Scripps College,123165,"Fully online, no students on campus",https://www.scrippscollege.edu/scripps-strong/scripps-covid-19-response/,06037,1063,Primarily Online,343,1406
Highland Community College,155186,"Fully online, no students on campus",https://highland.edu/hcc-advisory/,20043,1066,Primarily Online,240,1306
Columbus College of Art and Design,202170,"Fully online, no students on campus",https://www.ccad.edu/publichealth,39049,1069,Primarily Online,240,1309
Dean College,165574,"Fully online, no students on campus",https://www.dean.edu/news-events/story/updates-on-coronavirus/,25021,1152,Primarily Online,239,1391
Barstow Community College,109907,"Fully online, no students on campus",http://www.barstow.edu/covid_19.html,06071,1186,Primarily Online,186,1372
Hendrix College,107080,"Fully online, no students on campus",https://www.hendrix.edu/coronavirus/,05045,1199,Primarily Online,391,1590
Albany Technical College,138682,"Fully online, no students on campus",https://www.albanytech.edu/coronavirus,13095,1213,Primarily Online,274,1487
Chestnut Hill College,211583,"Fully online, no students on campus",https://www.chc.edu/campus-plan-fall-2020,42101,1248,Primarily Online,249,1497
Parker University,243823,"Fully online, no students on campus",https://www.parker.edu/update/,48113,1269,Primarily Online,265,1534
Mount Wachusett Community College,166957,"Fully online, no students on campus",https://mwcc.edu/coronavirus-disease-2019-covid-19-information/,25027,1300,Primarily Online,595,1895
Claremont McKenna College,112260,"Fully online, no students on campus",https://cmcreturns.cmc.edu/,06037,1324,Primarily Online,484,1808
Los Angeles Southwest College,117715,"Fully online, no students on campus",http://laccd.edu/About/News/Pages/Coronavirus.aspx,06037,1337,Primarily Online,312,1649
Washington College,164216,"Fully online, no students on campus",https://www.washcoll.edu/coronavirus/,24029,1346,Primarily Online,428,1774
Bellingham Technical College,234696,"Fully online, no students on campus",https://www.btc.edu/AboutBTC/Safety/campushealth.asp,53073,1441,Primarily Online,233,1674
Kalamazoo College,170532,"Fully online, no students on campus",https://healthcenter.kzoo.edu/coronavirus-disease-2019-covid-19-campus-updates/,26077,1457,Primarily Online,379,1836
Massachusetts Bay Community College,166647,"Fully online, no students on campus",https://www.massbay.edu/coronavirus1,25021,1471,Primarily Online,356,1827
Lake Forest College,146481,"Fully online, no students on campus",http://www.lakeforest.edu/about/administration/coronavirus-resources.php,17097,1477,Primarily Online,328,1805
Becker College,164720,"Fully online, no students on campus",https://www.becker.edu/student-life/student-support/health-services/additional-information-and-faqs-about-coronavirus/,25027,1478,Primarily Online,285,1763
Johnson C Smith University,198756,"Fully online, no students on campus",https://www.jcsu.edu/news-events/jcsu-alert/covid-19-novel-coronavirus-information/covid-19-novel-coronavirus-information,37119,1499,Primarily Online,294,1793
Pomona College,121345,"Fully online, no students on campus",https://www.pomona.edu/coronavirus,06037,1559,Primarily Online,781,2340
Berkeley City College,125170,"Fully online, no students on campus",https://www.berkeleycitycollege.edu/wp/covid-19/,06001,1648,Primarily Online,186,1834
Queens University of Charlotte,199412,"Fully online, no students on campus",https://www.queens.edu/news/2020/health-advisory.html,37119,1652,Primarily Online,450,2102
Texas Southmost College,227377,"Fully online, no students on campus",https://www.tsc.edu/coronavirus-update-stay-healthy-stay-safe/,48061,1666,Primarily Online,401,2067
Central Arizona College,104346,"Fully online, no students on campus",https://centralaz.edu/cac-cares/returning-to-campus/,04021,1714,Primarily Online,497,2211
Jackson College,170444,"Fully online, no students on campus",https://www.jccmi.edu/covid-19/,26075,1802,Primarily Online,236,2038
Occidental College,120254,"Fully online, no students on campus",https://www.oxy.edu/covid-19,06037,1907,Primarily Online,730,2637
Maryland Institute College of Art,163295,"Fully online, no students on campus",https://www.mica.edu/campus-operating-status-updates/mica-and-covid-19/,24510,1986,Primarily Online,685,2671
Franklin University,202806,"Fully online, no students on campus",https://www.franklin.edu/coronavirus,39049,1993,Primarily Online,684,2677
Crafton Hills College,113111,"Fully online, no students on campus",https://www.craftonhills.edu/features/covid-19-response-resources/index.php,06071,2015,Primarily Online,308,2323
Spelman College,141060,"Fully online, no students on campus",https://www.spelman.edu/student-life/health-and-wellness/health-services/coronavirus,13121,2123,Primarily Online,614,2737
Morehouse College,140553,"Fully online, no students on campus",https://morehouse.edu/coronavirus-updates/,13121,2146,Primarily Online,408,2554
San Jose City College,122746,"Fully online, no students on campus",https://www.sjeccd.edu/discover-sjeccd/chancellor/covid-19-novel-coronavirus-info,06085,2162,Primarily Online,350,2512
Los Angeles Mission College,117867,"Fully online, no students on campus",http://laccd.edu/About/News/Pages/Coronavirus.aspx,06037,2194,Primarily Online,364,2558
Monterey Peninsula College,119067,"Fully online, no students on campus",https://www.mpc.edu/about-mpc/campus-information/campus-safety/emergency-action-contact-guide/covid-19,06053,2342,Primarily Online,377,2719
Dickinson College,212009,"Fully online, no students on campus",https://www.dickinson.edu/info/20051/global_study_and_engagement/3976/dickinson_college_updates_on_the_coronavirus,42041,2361,Primarily Online,882,3243
Wenatchee Valley College,236975,"Fully online, no students on campus",https://www.wvc.edu/students/safety/publichealth/,53007,2397,Primarily Online,277,2674
University of Lynchburg,232609,"Fully online, no students on campus",https://www.lynchburg.edu/about/covid-19/,51680,2450,Primarily Online,593,3043
University of Baltimore,161873,"Fully online, no students on campus",http://www.ubalt.edu/about-ub/offices-and-services/university-police/campus-safety/emergencies/emergency-preparedness/medical-emergencies/stay-healthy.cfm,24510,2509,Primarily Online,694,3203
Los Angeles Harbor College,117690,"Fully online, no students on campus",https://www.laccd.edu/About/News/Pages/Coronavirus.aspx,06037,2545,Primarily Online,326,2871
West Los Angeles College,125471,"Fully online, no students on campus",http://www.laccd.edu/About/News/Pages/Coronavirus.aspx,06037,2664,Primarily Online,436,3100
Stevenson University,164173,"Fully online, no students on campus",https://www.stevenson.edu/about/campus-services/alert/emergency-information/,24005,2800,Primarily Online,550,3350
Smith College,167835,"Fully online, no students on campus",https://www.smith.edu/covid19,25015,2868,Primarily Online,1197,4065
Pennsylvania State University-World Campus,479956,"Fully online, no students on campus",https://www.worldcampus.psu.edu/about-us/news-and-features/updates-regarding-coronavirus,42027,2991,Primarily Online,0,2991
Evergreen Valley College,114266,"Fully online, no students on campus",https://www.evc.edu/current-students,06085,3138,Primarily Online,345,3483
Los Angeles Trade Technical College,117724,"Fully online, no students on campus",https://www.laccd.edu/About/News/Pages/Coronavirus.aspx,06037,3187,Primarily Online,537,3724
John Carroll University,203368,"Fully online, no students on campus",https://jcu.edu/fall-plan-2020,39035,3230,Primarily Online,598,3828
Coastal Alabama Community College,101161,"Fully online, no students on campus",http://www.coastalalabama.edu/coronavirus/,01003,3444,Primarily Online,410,3854
Clark Atlanta University,138947,"Fully online, no students on campus",https://www.cau.edu/cau-update/,13121,3619,Primarily Online,612,4231
La Salle University,213367,"Fully online, no students on campus",https://www.lasalle.edu/news/covid-19/,42101,3621,Primarily Online,767,4388
Anne Arundel Community College,161767,"Fully online, no students on campus",https://www.aacc.edu/newsroom/stay-healthy/,24003,3661,Primarily Online,1211,4872
University of Redlands,121691,"Fully online, no students on campus",,06071,3857,Primarily Online,876,4733
Victor Valley College,125091,"Fully online, no students on campus",http://vvcforme.com/pubinfomktg/2020/03/09/victor-valley-college-coronavirus-covid-19-information/,06071,3889,Primarily Online,579,4468
Los Angeles City College,117788,"Fully online, no students on campus",https://www.laccd.edu/About/News/Pages/Coronavirus.aspx,06037,3935,Primarily Online,584,4519
Hampton University,232265,"Fully online, no students on campus",http://alert.hamptonu.edu/,51650,4050,Primarily Online,1023,5073
Virginia State University,234155,"Fully online, no students on campus",http://www.vsu.edu/Fall2020/index.php,51041,4075,Primarily Online,884,4959
Ventura College,125028,"Fully online, no students on campus",https://www.vcccd.edu/news/vcccd-alerts,06111,4105,Primarily Online,435,4540
Los Angeles Valley College,117733,"Fully online, no students on campus",http://laccd.edu/About/News/Pages/Coronavirus.aspx,06037,4115,Primarily Online,584,4699
Bunker Hill Community College,165112,"Fully online, no students on campus",https://www.bhcc.edu/coronavirus-info/,25025,4156,Primarily Online,672,4828
Harrisburg University of Science and Technology,446640,"Fully online, no students on campus",https://covid.harrisburgu.edu,42043,4158,Primarily Online,342,4500
SUNY College at Old Westbury,196237,"Fully online, no students on campus",https://www.oldwestbury.edu/campus-guide,36059,4311,Primarily Online,593,4904
College of the Desert,113573,"Fully online, no students on campus",http://www.collegeofthedesert.edu/students/hs/virus/Pages/default.aspx,06065,4577,Primarily Online,603,5180
Rio Hondo College,121886,"Fully online, no students on campus",https://www.riohondo.edu/student-health-services/coronavirus/,06037,4630,Primarily Online,634,5264
Irvine Valley College,116439,"Fully online, no students on campus",http://www.ivc.edu/coronavirus/Pages/default.aspx,06059,4831,Primarily Online,510,5341
Community College of Philadelphia,215239,"Fully online, no students on campus",https://www.myccp.online/coronavirus,42101,4917,Primarily Online,1020,5937
Wilmington University,131113,"Fully online, no students on campus",https://www.wilmu.edu/alerts/coronavirus.aspx,10003,4984,Primarily Online,1062,6046
California University of Pennsylvania,211361,"Fully online, no students on campus",https://www.calu.edu/coronaplan/important-messages.aspx,42125,4999,Primarily Online,724,5723
Cypress College,113236,"Fully online, no students on campus",https://www.cypresscollege.edu/coronavirus/,06059,5096,Primarily Online,572,5668
Harrisburg Area Community College,212878,"Fully online, no students on campus",https://www.hacc.edu/Resources/stay-up-to-date-on-the-coronavirus.cfm,42043,5222,Primarily Online,1371,6593
Los Angeles Pierce College,117706,"Fully online, no students on campus",http://laccd.edu/About/News/Pages/Coronavirus.aspx,06037,5363,Primarily Online,686,6049
Citrus College,112172,"Fully online, no students on campus",https://www.citruscollege.edu/covid19/Pages/default.aspx,06037,5416,Primarily Online,554,5970
Ithaca College,191968,"Fully online, no students on campus",https://www.ithaca.edu/coronavirus-updates,36109,6345,Primarily Online,1456,7801
Sierra College,123341,"Fully online, no students on campus",https://www.sierracollege.edu/about-us/covid-19.php,06061,6503,Primarily Online,802,7305
Glendale Community College,115001,"Fully online, no students on campus",https://www.glendale.edu/students/student-services/health-center/what-you-need-to-know,06037,6519,Primarily Online,736,7255
Bellevue College,234669,"Fully online, no students on campus",https://www.bellevuecollege.edu/publicsafety/flu/,53033,6866,Primarily Online,853,7719
Fullerton College,114859,"Fully online, no students on campus",https://coronavirus.fullcoll.edu/,06059,7225,Primarily Online,770,7995
Montgomery College,163426,"Fully online, no students on campus",https://www.montgomerycollege.edu/coronavirus/,24031,7571,Primarily Online,2185,9756
East Los Angeles College,113856,"Fully online, no students on campus",http://www.laccd.edu/About/News/Pages/Coronavirus.aspx,06037,7810,Primarily Online,969,8779
Howard University,131520,"Fully online, no students on campus",https://home.howard.edu/coronavirus,11001,8500,Primarily Online,2500,11000
Portland Community College,209746,"Fully online, no students on campus",https://www.pcc.edu/coronavirus/,41051,10724,Primarily Online,2030,12754
Santa Monica College,122977,"Fully online, no students on campus",http://www.smc.edu/NewsRoom/coronavirus/Pages/default.aspx,06037,11035,Primarily Online,1229,12264
American University,131159,"Fully online, no students on campus",https://www.american.edu/coronavirus/,11001,11435,Primarily Online,3032,14467
West Chester University of Pennsylvania,216764,"Fully online, no students on campus",https://www.wcupa.edu/healthNotices/default.aspx,42029,14079,Primarily Online,1723,15802
Georgetown University,131496,"Fully online, no students on campus",,11001,14741,Primarily Online,5632,20373
California State University-Chico,110538,"Fully online, no students on campus",https://www.csuchico.edu/coronavirus/,06007,16001,Primarily Online,1644,17645
Drexel University,212054,"Fully online, no students on campus",https://drexel.edu/now/coronavirus/response/,42101,18312,Primarily Online,4731,23043
Lone Star College System,227182,"Fully online, no students on campus",https://www.lonestar.edu/Fall2020,48339,19945,Primarily Online,4405,24350
East Carolina University,198464,"Fully online, no students on campus",https://returnofpiratenation.ecu.edu/,37147,22087,Primarily Online,5772,27859
California State Polytechnic University-Pomona,110529,"Fully online, no students on campus",https://www.cpp.edu/safety/coronavirus/index.shtml,06037,22626,Primarily Online,2082,24708
Michigan State University,171100,"Fully online, no students on campus",https://msu.edu/together-we-will/?utm_campaign=standard-promo&utm_source=msuhome&utm_medium=msuhome,26065,43863,Primarily Online,12425,56288
Southwestern Christian College,228486,Hybrid or Hyflex teaching,http://www.swcc.edu/corona-update-online-courses.pdf,48257,80,Hybrid,31,111
Oak Hills Christian College,174525,Hybrid or Hyflex teaching,https://www.oakhills.edu/covid-19-update,27007,83,Hybrid,30,113
Kuyper College,171881,Hybrid or Hyflex teaching,https://www.kuyper.edu/covid-19-updates/,26081,130,Hybrid,36,166
Providence Christian College,455770,Hybrid or Hyflex teaching,https://www.providencecc.edu/covid-19/,06037,168,Hybrid,39,207
University of New Mexico-Los Alamos Campus,187976,Hybrid or Hyflex teaching,https://www.unm.edu/coronavirus/,35028,174,Hybrid,49,223
Rainy River Community College,174604,Hybrid or Hyflex teaching,https://www.rainyriver.edu/college-services/campus-health-safety/coronavirus-disease-covid-19,27071,177,Hybrid,29,206
Jacksonville College-Main Campus,225876,Hybrid or Hyflex teaching,https://www.jacksonville-college.edu/update,48073,242,Hybrid,58,300
New York School of Interior Design,194116,Hybrid or Hyflex teaching,https://www.nysid.edu/coronavirus,36061,277,Hybrid,89,366
John Paul the Great Catholic University,462354,Hybrid or Hyflex teaching,https://jpcatholic.edu/news/index.php,06073,287,Hybrid,56,343
University of New Mexico-Taos Campus,188225,Hybrid or Hyflex teaching,http://taos.unm.edu/home/covid19/,35055,301,Hybrid,109,410
College of the Atlantic,160959,Hybrid or Hyflex teaching,https://www.coa.edu/news/covid-19/,23009,322,Hybrid,92,414
University of Arkansas Community College Rich Mountain,107743,Hybrid or Hyflex teaching,https://www.uarichmountain.edu/coronavirus,05113,331,Hybrid,99,430
Clatsop Community College,208415,Hybrid or Hyflex teaching,https://www.clatsopcc.edu/campus-information/campus-safety/covid-19-campus-updates/,41007,334,Hybrid,129,463
Warner Pacific University,210304,Hybrid or Hyflex teaching,https://www.warnerpacific.edu/covid-19-faq/,41051,363,Hybrid,114,477
San Francisco Conservatory of Music,122506,Hybrid or Hyflex teaching,https://sfcm.edu/newsroom/coronavirus-update,06075,397,Hybrid,106,503
Mercyhurst University-North East Campus,480189,Hybrid or Hyflex teaching,https://www.mercyhurst.edu/covid19,42049,425,Hybrid,97,522
Clarks Summit University,211024,Hybrid or Hyflex teaching,https://www.clarkssummitu.edu/coronavirus/,42069,475,Hybrid,88,563
Northwest State Community College,204440,Hybrid or Hyflex teaching,https://northweststate.edu/covid-19/,39069,475,Hybrid,156,631
Benjamin Franklin Institute of Technology,165884,Hybrid or Hyflex teaching,https://www.bfit.edu/student-life/health-wellness/coronavirus/,25025,476,Hybrid,130,606
Defiance College,202514,Hybrid or Hyflex teaching,http://www.defiance.edu/information/covid-19-fall2020-updates.html,39039,487,Hybrid,129,616
Western Texas College,229832,Hybrid or Hyflex teaching,https://www.wtc.edu/Information/covid-19-updates.html,48415,500,Hybrid,172,672
Henderson Community College,156851,Hybrid or Hyflex teaching,https://henderson.kctcs.edu/covid-19/,21101,506,Hybrid,107,613
Piedmont International University,489937,Hybrid or Hyflex teaching,https://piedmontu.edu/coronavirus,37067,535,Hybrid,120,655
Kettering College,203544,Hybrid or Hyflex teaching,http://kc.edu/coronavirus/,39113,546,Hybrid,123,669
University of New Mexico-Valencia County Campus,188049,Hybrid or Hyflex teaching,https://valencia.unm.edu/campus-reopening.html,35061,562,Hybrid,137,699
Ursuline College,206349,Hybrid or Hyflex teaching,https://www.ursuline.edu/student-life/coronavirus,39035,571,Hybrid,209,780
Bethany College,237181,Hybrid or Hyflex teaching,https://www.bethanywv.edu/student-life/health-wellness/,54009,574,Hybrid,164,738
Central Baptist College,106713,Hybrid or Hyflex teaching,https://www.cbc.edu/Articles/cbc-fall-semester-update,05045,576,Hybrid,113,689
Rosemont College,215691,Hybrid or Hyflex teaching,https://www.rosemont.edu/about/rosemont-2020/,42091,596,Hybrid,166,762
College of Saint Elizabeth,186618,Hybrid or Hyflex teaching,https://www.steu.edu/web/guest/student-life/health-services/coronavirus-information,34027,717,Hybrid,224,941
Milwaukee Institute of Art & Design,239309,Hybrid or Hyflex teaching,https://www.miad.edu/coronavirus,55079,738,Hybrid,163,901
Fisk University,220181,Hybrid or Hyflex teaching,https://www.fisk.edu/fisk-cares-act-report/,47037,749,Hybrid,191,940
Minneapolis College of Art and Design,174127,Hybrid or Hyflex teaching,https://mcad.edu/covid19,27053,749,Hybrid,202,951
Kentucky Wesleyan College,157076,Hybrid or Hyflex teaching,https://kwc.edu/coronavirus/,21059,753,Hybrid,152,905
Eastern Oklahoma State College,207050,Hybrid or Hyflex teaching,http://www.eosc.edu/Articles/eastern_oklahoma_state_college_announces_reopening_plan_for_fall_semester.aspx,40077,781,Hybrid,195,976
Wor-Wic Community College,164313,Hybrid or Hyflex teaching,https://www.worwic.edu/Services-Support/Public-Safety/Coronavirus-Info,24045,786,Hybrid,314,1100
Emmanuel College,139630,Hybrid or Hyflex teaching,https://www.emmanuel.edu/covid-19.html,13119,811,Hybrid,167,978
Spartanburg Methodist College,218821,Hybrid or Hyflex teaching,https://www.smcsc.edu/response-covid19/,45083,856,Hybrid,142,998
Wisconsin Lutheran College,240338,Hybrid or Hyflex teaching,https://www.wlc.edu/coronavirus/,55079,958,Hybrid,176,1134
Hastings College,181127,Hybrid or Hyflex teaching,https://www.hastings.edu/news/hastings-college-coronavirus-information/,31001,980,Hybrid,197,1177
Vermont Technical College,231165,Hybrid or Hyflex teaching,https://www.vtc.edu/update-on-the-covid-19-coronavirus/,50017,988,Hybrid,270,1258
Hopkinsville Community College,156860,Hybrid or Hyflex teaching,https://hopkinsville.kctcs.edu/covid-19/,21047,999,Hybrid,171,1170
Murray State College,207236,Hybrid or Hyflex teaching,https://www.mscok.edu/current-students/covid-19,40069,1004,Hybrid,195,1199
Crown College,174862,Hybrid or Hyflex teaching,https://www.crown.edu/coronavirus/,27019,1043,Hybrid,120,1163
Talladega College,102298,Hybrid or Hyflex teaching,http://www.talladega.edu/joomla25/COVID19_FACTS_SUCCESSFUL_REOPENING_TALLADEGA_COLLEGE_FALL_2020.pdf,01121,1090,Hybrid,177,1267
Coconino Community College,404426,Hybrid or Hyflex teaching,https://www.coconino.edu/coronavirus,04005,1103,Hybrid,202,1305
Ferrum College,232089,Hybrid or Hyflex teaching,https://www.ferrum.edu/blog/coronavirus/,51067,1104,Hybrid,260,1364
Centenary University,183974,Hybrid or Hyflex teaching,https://www.centenaryuniversity.edu/coronavirus-communications/,34041,1118,Hybrid,219,1337
Massachusetts College of Liberal Arts,167288,Hybrid or Hyflex teaching,http://www.mcla.edu/Student_Life/wellness/healthservices/coronavirus/index.html,25003,1121,Hybrid,359,1480
Notre Dame College,204468,Hybrid or Hyflex teaching,https://www.notredamecollege.edu/about/experience-the-college/news-and-media/return-to-campus/,39035,1163,Hybrid,239,1402
Hampshire College,166018,Hybrid or Hyflex teaching,https://www.hampshire.edu/news/2020/06/23/hamp-forward-fall-2020,25015,1191,Hybrid,257,1448
University of Minnesota-Crookston,174075,Hybrid or Hyflex teaching,https://safe-campus.umn.edu/public-health-alerts,27119,1206,Hybrid,257,1463
Thaddeus Stevens College of Technology,216296,Hybrid or Hyflex teaching,https://stevenscollege.edu/coronavirus/,42071,1220,Hybrid,157,1377
Dillard University,158802,Hybrid or Hyflex teaching,https://www.dillard.edu/covid-19/index.php,22071,1223,Hybrid,320,1543
Beloit College,238333,Hybrid or Hyflex teaching,https://www.beloit.edu/back-at-beloit/updates-announcements/,55105,1228,Hybrid,296,1524
Snead State Community College,102076,Hybrid or Hyflex teaching,http://www.snead.edu/current_students/coronavirus_covid-19_information.aspx,01095,1236,Hybrid,153,1389
Wesley College,131098,Hybrid or Hyflex teaching,https://wesley.edu/coronavirus-covid-19-information,10001,1243,Hybrid,245,1488
Albany College of Pharmacy and Health Sciences,188526,Hybrid or Hyflex teaching,https://www.acphs.edu/Coronavirus,36001,1319,Hybrid,259,1578
University of Saint Joseph,130314,Hybrid or Hyflex teaching,https://www.usj.edu/student-life/coronavirus-covid-19/,09003,1338,Hybrid,599,1937
Spalding University,157757,Hybrid or Hyflex teaching,https://spalding.edu/coronavirus-disease-information/,21111,1341,Hybrid,254,1595
Northeastern Oklahoma A&M College,207290,Hybrid or Hyflex teaching,http://www.neo.edu/neo-campus-covid-19-update/,40115,1383,Hybrid,184,1567
Alverno College,238193,Hybrid or Hyflex teaching,https://www.alverno.edu/welcome-back.php,55079,1384,Hybrid,332,1716
Herkimer County Community College,191612,Hybrid or Hyflex teaching,https://www.herkimer.edu/coronavirus/,36043,1396,Hybrid,202,1598
Loras College,153825,Hybrid or Hyflex teaching,https://www.loras.edu/coronavirus/,19061,1414,Hybrid,321,1735
Edgewood College,238661,Hybrid or Hyflex teaching,https://www.edgewood.edu/covid-19,55025,1417,Hybrid,415,1832
Maysville Community and Technical College,157331,Hybrid or Hyflex teaching,https://maysville.kctcs.edu/covid-19/,21161,1463,Hybrid,228,1691
University of Minnesota-Morris,174251,Hybrid or Hyflex teaching,https://morris.umn.edu/covid-19-updates/covid-19-umn-morris/return-campus-morris,27149,1463,Hybrid,356,1819
Thomas More College,157809,Hybrid or Hyflex teaching,https://www.thomasmore.edu/covid-19/,21117,1510,Hybrid,222,1732
Cabrini University,211352,Hybrid or Hyflex teaching,https://www.cabrini.edu/about/media-hub/news/2020/d-taylor-covid-19-update,42045,1582,Hybrid,323,1905
Southern University at New Orleans,160630,Hybrid or Hyflex teaching,http://www.suno.edu/news/safesuno,22071,1684,Hybrid,290,1974
Saint Johns University,174792,Hybrid or Hyflex teaching,https://www.csbsju.edu/covid-19,27145,1697,Hybrid,460,2157
Mount Saint Mary College,193353,Hybrid or Hyflex teaching,https://www.msmc.edu/c/reopening-plans,36071,1736,Hybrid,398,2134
Lewis and Clark Community College,146603,Hybrid or Hyflex teaching,https://www.lc.edu/coronavirus/,17119,1739,Hybrid,429,2168
Massachusetts College of Art and Design,166674,Hybrid or Hyflex teaching,https://massart.edu/coronavirus,25025,1739,Hybrid,452,2191
Cumberland University,219949,Hybrid or Hyflex teaching,https://www.cumberland.edu/coronavirus/,47189,1758,Hybrid,248,2006
Southcentral Kentucky Community and Technical College,156338,Hybrid or Hyflex teaching,https://southcentral.kctcs.edu/covid-19/,21227,1760,Hybrid,284,2044
Arkansas State University-Beebe,106449,Hybrid or Hyflex teaching,http://www.asub.edu/coronavirus-information/index.aspx,05145,1779,Hybrid,328,2107
The Sage Colleges,195128,Hybrid or Hyflex teaching,https://sites.google.com/sage.edu/covid19,36083,1787,Hybrid,350,2137
Texas Wesleyan University,229160,Hybrid or Hyflex teaching,https://txwes.edu/coronavirus/,48439,1790,Hybrid,426,2216
Connecticut College,128902,Hybrid or Hyflex teaching,https://www.conncoll.edu/campus-life/student-health-services/coronavirus/returning-to-conn-faqs/,09011,1798,Hybrid,714,2512
Albright College,210571,Hybrid or Hyflex teaching,https://www.albright.edu/about-albright/buildings-facilities/gable-center/covid-19/,42011,1887,Hybrid,361,2248
La Sierra University,117627,Hybrid or Hyflex teaching,https://lasierra.edu/covid-19/,06065,1914,Hybrid,341,2255
Luther College,153834,Hybrid or Hyflex teaching,https://www.luther.edu/headlines/?story_id=910677,19191,1977,Hybrid,439,2416
D'Youville College,190716,Hybrid or Hyflex teaching,http://www.dyc.edu/campus-life/support-services/covid-19/,36029,2146,Hybrid,479,2625
The University of Texas of the Permian Basin,229018,Hybrid or Hyflex teaching,https://www.utpb.edu/announcements/coronavirus,48135,2148,Hybrid,682,2830
Franklin and Marshall College,212577,Hybrid or Hyflex teaching,https://www.fandm.edu/campus-life/services-policies/student-wellness-center/flu-season-precautions,42071,2290,Hybrid,828,3118
Gadsden State Community College,101240,Hybrid or Hyflex teaching,https://www.gadsdenstate.edu/about-us/coronavirus.cms,01055,2299,Hybrid,424,2723
Wheaton College,149781,Hybrid or Hyflex teaching,https://wheatoncollege.blog/student-life-events/student-health-services/statement-regarding-coronavirus/,17043,2601,Hybrid,820,3421
Davenport University,169479,Hybrid or Hyflex teaching,https://www.davenport.edu/coronavirus,26081,2731,Hybrid,662,3393
Tuskegee University,102377,Hybrid or Hyflex teaching,https://www.tuskegee.edu/coronavirus-resources,01087,2907,Hybrid,733,3640
Pacific Lutheran University,236230,Hybrid or Hyflex teaching,https://www.plu.edu/coronavirus/,53053,2992,Hybrid,700,3692
Dallas Baptist University,224226,Hybrid or Hyflex teaching,https://www.dbu.edu/coronavirus/latest-updates.html,48113,3077,Hybrid,477,3554
The University of Findlay,202763,Hybrid or Hyflex teaching,https://www.findlay.edu/oiler-start-safe-and-stay-safe,39063,3092,Hybrid,634,3726
Seattle Pacific University,236577,Hybrid or Hyflex teaching,https://spu.edu/administration/health-services/hs-news/2020/COVID-19,53033,3125,Hybrid,685,3810
Fairmont State University,237367,Hybrid or Hyflex teaching,https://www.fairmontstate.edu/coronavirus,54049,3217,Hybrid,432,3649
Maryville University of Saint Louis,178059,Hybrid or Hyflex teaching,https://www.maryville.edu/saintstrong/,29189,3308,Hybrid,765,4073
Jefferson Community and Technical College,156921,Hybrid or Hyflex teaching,https://jefferson.kctcs.edu/covid-19/index.aspx,21111,3399,Hybrid,558,3957
Southwestern Illinois College,143215,Hybrid or Hyflex teaching,https://www.swic.edu/students/public-safety/notifications/awareness-updates/,17163,3551,Hybrid,586,4137
Clarkson University,190044,Hybrid or Hyflex teaching,https://www.clarkson.edu/future-ready,36089,3651,Hybrid,766,4417
Auburn University at Montgomery,100830,Hybrid or Hyflex teaching,http://www.aum.edu/coronavirus,01101,3775,Hybrid,622,4397
University of Tulsa,207971,Hybrid or Hyflex teaching,https://utulsa.edu/coronavirus/,40143,3917,Hybrid,1233,5150
Alabama State University,100724,Hybrid or Hyflex teaching,https://www.alasu.edu/coronavirus-covid-19-updates,01101,3934,Hybrid,861,4795
Merrimack College,166850,Hybrid or Hyflex teaching,https://www.merrimack.edu/health-alerts/,25009,3966,Hybrid,722,4688
Wentworth Institute of Technology,168227,Hybrid or Hyflex teaching,https://wit.edu/coronavirus,25025,4005,Hybrid,622,4627
Providence College,217402,Hybrid or Hyflex teaching,https://covid-19.providence.edu/2020/07/29/7-29-20-academic-plan-update-for-students-and-families/,44007,4096,Hybrid,941,5037
University of Detroit Mercy,169716,Hybrid or Hyflex teaching,https://www.udmercy.edu/coronavirus/,26163,4156,Hybrid,1016,5172
Emerson College,165662,Hybrid or Hyflex teaching,https://www.emerson.edu/covid-19,25025,4407,Hybrid,876,5283
Onondaga Community College,194222,Hybrid or Hyflex teaching,https://www.sunyocc.edu/fall2020,36067,4725,Hybrid,785,5510
The University of Tennessee-Martin,221768,Hybrid or Hyflex teaching,https://www.utm.edu/alerts/corona.php,47183,4806,Hybrid,855,5661
Samford University,102049,Hybrid or Hyflex teaching,https://www.samford.edu/emergency/information/coronavirus/,01073,5292,Hybrid,1068,6360
University of North Alabama,101879,Hybrid or Hyflex teaching,https://www.una.edu/university-communications/covid-19.html,01077,5298,Hybrid,788,6086
University of New England,161457,Hybrid or Hyflex teaching,https://www.une.edu/onward,23031,5331,Hybrid,1135,6466
Southeastern University,137564,Hybrid or Hyflex teaching,https://www.seu.edu/coronavirus-covid-19-updates/,12105,5340,Hybrid,681,6021
Worcester Polytechnic Institute,168421,Hybrid or Hyflex teaching,https://www.wpi.edu/we-are-wpi,25027,5371,Hybrid,1292,6663
The University of Texas at Tyler,228802,Hybrid or Hyflex teaching,https://www.uttyler.edu/coronavirus/,48423,5486,Hybrid,1076,6562
Alabama A & M University,100654,Hybrid or Hyflex teaching,https://www.aamu.edu/campus-life/student-support/health-services/coronavirus/index.html,01089,5492,Hybrid,799,6291
University of New Orleans,159939,Hybrid or Hyflex teaching,https://www.uno.edu/covid-19,22071,5610,Hybrid,1123,6733
Stevens Institute of Technology,186867,Hybrid or Hyflex teaching,https://www.stevens.edu/about-stevens/return-campus,34017,5718,Hybrid,1078,6796
Mississippi Gulf Coast Community College,176071,Hybrid or Hyflex teaching,https://mgccc.edu/coronavirus/,28131,5756,Hybrid,821,6577
Purdue University Fort Wayne,151102,Hybrid or Hyflex teaching,https://www.pfw.edu/microsites/pfw-prepared/,18003,5838,Hybrid,1068,6906
Morehead State University,157386,Hybrid or Hyflex teaching,https://www.moreheadstate.edu/Administration/Emergency-Resources/What-to-do-if/Coronavirus/Healthy-at-MSU,21205,5982,Hybrid,942,6924
Salem State University,167729,Hybrid or Hyflex teaching,https://www.salemstate.edu/coronavirus-preparedness,25009,5982,Hybrid,1007,6989
MCPHS University,166656,Hybrid or Hyflex teaching,https://www.mcphs.edu/covid,25025,6144,Hybrid,937,7081
University of Massachusetts-Dartmouth,167987,Hybrid or Hyflex teaching,https://www.umassd.edu/emergency/coronavirus/1,25005,6531,Hybrid,1178,7709
University of Alabama in Huntsville,100706,Hybrid or Hyflex teaching,https://www.uah.edu/return-to-campus,01089,7125,Hybrid,1460,8585
University of St Thomas,174914,Hybrid or Hyflex teaching,https://www.stthomas.edu/covid19/,27123,7372,Hybrid,1556,8928
Lindenwood University,177968,Hybrid or Hyflex teaching,https://www.lindenwood.edu/coronavirus/roaring-return/,29183,7373,Hybrid,1120,8493
Seton Hall University,186584,Hybrid or Hyflex teaching,https://www.shu.edu/health-intervention-communication/covid-19-updates.cfm,34013,7589,Hybrid,1650,9239
Duquesne University,212106,Hybrid or Hyflex teaching,https://covid19.duq.edu,42003,8867,Hybrid,1748,10615
Western Carolina University,200004,Hybrid or Hyflex teaching,https://www.wcu.edu/operations-procedures/index.aspx,37099,9381,Hybrid,1618,10999
Northern Kentucky University,157447,Hybrid or Hyflex teaching,https://www.nku.edu/covid19.html,21037,9503,Hybrid,1600,11103
Southeastern Louisiana University,160612,Hybrid or Hyflex teaching,http://www.southeastern.edu/about/safe_campus/covid-19/,22105,9563,Hybrid,1338,10901
Troy University,102368,Hybrid or Hyflex teaching,https://www.troy.edu/coronavirus/,01109,10305,Hybrid,1896,12201
Tufts University,168148,Hybrid or Hyflex teaching,https://coronavirus.tufts.edu/,25017,10718,Hybrid,4463,15181
South Texas College,409315,Hybrid or Hyflex teaching,https://www.southtexascollege.edu/emergency/coronavirus.html,48215,10854,Hybrid,1992,12846
Minnesota State University-Mankato,173920,Hybrid or Hyflex teaching,https://mankato.mnsu.edu/about-the-university/news-and-events/covid-19-novel-coronavirus-and-the-campus-community/,27013,11167,Hybrid,1337,12504
North Dakota State University-Main Campus,200332,Hybrid or Hyflex teaching,https://www.ndsu.edu/admission/fall_2020_prelim_plan,38017,11269,Hybrid,2398,13667
Vanderbilt University,221999,Hybrid or Hyflex teaching,https://www.vanderbilt.edu/coronavirus/,47037,11864,Hybrid,5761,17625
University of Rhode Island,217484,Hybrid or Hyflex teaching,https://web.uri.edu/coronavirus/,44009,14321,Hybrid,2790,17111
Sam Houston State University,227881,Hybrid or Hyflex teaching,https://www.shsu.edu/katsafe/restart2020/index.html,48471,15745,Hybrid,2264,18009
Central Michigan University,169248,Hybrid or Hyflex teaching,https://www.cmich.edu/firedupforfall/Pages/default.aspx,26073,15966,Hybrid,2458,18424
Baylor University,223232,Hybrid or Hyflex teaching,https://www.baylor.edu/coronavirus/,48309,16451,Hybrid,3152,19603
Missouri State University-Springfield,179566,Hybrid or Hyflex teaching,https://www.missouristate.edu/Coronavirus/?rel=20200706T1534,29077,16509,Hybrid,2378,18887
University of Nevada-Reno,182290,Hybrid or Hyflex teaching,https://www.unr.edu/coronavirus,32031,16768,Hybrid,3675,20443
University of New Mexico-Main Campus,187985,Hybrid or Hyflex teaching,http://www.unm.edu/coronavirus/,35001,16897,Hybrid,6770,23667
Syracuse University,196413,Hybrid or Hyflex teaching,https://www.syracuse.edu/fall2020/,36067,19184,Hybrid,5048,24232
The University of Texas Rio Grande Valley,227368,Hybrid or Hyflex teaching,https://www.utrgv.edu/coronavirus/,48215,20372,Hybrid,3748,24120
Northeastern University,167358,Hybrid or Hyflex teaching,https://news.northeastern.edu/coronavirus/,25025,20785,Hybrid,4406,25191
The University of Texas at Dallas,228787,Hybrid or Hyflex teaching,https://www.utdallas.edu/coronavirus/,48113,22708,Hybrid,3633,26341
The University of Texas at Arlington,228769,Hybrid or Hyflex teaching,https://www.uta.edu/announcements/coronavirus,48439,23870,Hybrid,3570,27440
Auburn University,100858,Hybrid or Hyflex teaching,https://ocm.auburn.edu/news/coronavirus/,01081,25806,Hybrid,5752,31558
University of Colorado Boulder,126614,Hybrid or Hyflex teaching,https://www.colorado.edu/covid-19,08013,30730,Hybrid,8317,39047
The University of Texas at Austin,228778,Hybrid or Hyflex teaching,https://coronavirus.utexas.edu/,48453,48542,Hybrid,14942,63484
Life University,140252,"Primarily online, some courses in person",https://www.life.edu/campus-life-pages/health-services/coronavirus/,13067,2377,Primarily Online,474,2851
Pacific Bible College,407610,"Primarily in person, some courses online",https://pacificlife.edu/covid-19-updates/,41029,9,Primarily In Person,7,16
East-West University,490850,"Primarily in person, some courses online",https://www.eastwest.edu/articles/covid-19/,55078,10,Primarily In Person,0,10
Maple Springs Baptist Bible College and Seminary,446394,"Primarily in person, some courses online",https://msbbcs.edu/,24033,10,Primarily In Person,22,32
Bethel College,458113,"Primarily in person, some courses online",https://www.bethelks.edu/coronavirus-information,51650,12,Primarily In Person,5,17
Huntsville Bible College,449348,"Primarily in person, some courses online",https://huntsvillebiblecollege.org/covid-guidelines-2020-21/,01089,17,Primarily In Person,20,37
Community Christian College,446163,"Primarily in person, some courses online",https://www.cccollege.edu/covid-19-update,06071,24,Primarily In Person,8,32
Shasta Bible College and Graduate School,123280,"Primarily in person, some courses online",https://www.shasta.edu/covid-19--cares-act.html,06089,24,Primarily In Person,12,36
Heritage Christian University,101453,"Primarily in person, some courses online",https://www.hcu.edu/fall-semester-heritage-event-updates/,01077,35,Primarily In Person,29,64
Union Bible College,491525,"Primarily in person, some courses online",https://fa9ffa48-9829-4cdd-8e9e-d09c9d513a19.filesusr.com/ugd/9eeb26_b2081ff1fb1b4476b2488a7d5251095b.pdf,18057,37,Primarily In Person,33,70
Boston Baptist College,164614,"Primarily in person, some courses online",https://www.boston.edu/regatheringplan?rq=covid,25025,45,Primarily In Person,12,57
America Evangelical University,490081,"Primarily in person, some courses online",https://aeu.edu/board_jTLC41,06037,49,Primarily In Person,16,65
Texas County Technical College,441487,"Primarily in person, some courses online",https://texascountytech.edu/covid-19/,29215,55,Primarily In Person,12,67
Women's Institute of Torah Seminary,491631,"Primarily in person, some courses online",https://www.wits.edu/covid-19-response,24510,62,Primarily In Person,20,82
Mesivtha Tifereth Jerusalem of America,193070,"Primarily in person, some courses online",https://mtj.edu,36061,65,Primarily In Person,12,77
Bolivar Technical College,490203,"Primarily in person, some courses online",https://www.bolivarcollege.edu/covid-19/,29167,66,Primarily In Person,20,86
White Earth Tribal and Community College,434751,"Primarily in person, some courses online",https://www.wetcc.edu/covid.html,27087,66,Primarily In Person,30,96
Yeshiva Shaarei Torah of Rockland,441609,"Primarily in person, some courses online",https://www.yst.edu/home.html,36087,78,Primarily In Person,20,98
Champion Christian College,492069,"Primarily in person, some courses online",https://champion.edu/champion-christian-college-covid-19-response/,05051,81,Primarily In Person,21,102
VanderCook College of Music,149639,"Primarily in person, some courses online",https://www.vandercook.edu/covid-19/,17031,84,Primarily In Person,38,122
Elim Bible Institute and College,488305,"Primarily in person, some courses online",https://www.elim.edu/covid-19,36051,93,Primarily In Person,30,123
Boise Bible College,142090,"Primarily in person, some courses online",https://boisebible.edu/studentlife/boise-bible-and-fall-2020/,16001,96,Primarily In Person,21,117
Pittsburgh Institute of Mortuary Science Inc,215390,"Primarily in person, some courses online",https://pims.edu/covid-19-protocols-precautions-and-policies/,42003,97,Primarily In Person,17,114
Chatfield College,201751,"Primarily in person, some courses online",https://chatfield.edu/covid-19-update/,39015,102,Primarily In Person,53,155
Webb Institute,197221,"Primarily in person, some courses online",https://www.webb.edu/coronavirus/,36059,104,Primarily In Person,35,139
Sterling College,231095,"Primarily in person, some courses online",https://www.sterling.edu/student-life/covid-19-information,50019,109,Primarily In Person,46,155
Compass College of Cinematic Arts,459417,"Primarily in person, some courses online",https://compass.edu/CORONAVIRUS/,26081,113,Primarily In Person,19,132
Morrison Institute of Technology,147396,"Primarily in person, some courses online",https://www.morrisontech.edu/category/campus-events/,17195,115,Primarily In Person,23,138
Sacred Heart Major Seminary,172033,"Primarily in person, some courses online",https://www.shms.edu/covid-19,26163,116,Primarily In Person,60,176
Reformed University,490230,"Primarily in person, some courses online",https://runiv.edu/,13135,118,Primarily In Person,17,135
Davis College,194569,"Primarily in person, some courses online",https://www.davisny.edu/important-information-concerning-coronavirus-covid-19/,36007,125,Primarily In Person,17,142
Trinity College of Nursing & Health Sciences,146755,"Primarily in person, some courses online",https://www.trinitycollegeqc.edu/covid-19-college-update.aspx,17161,129,Primarily In Person,25,154
Ecclesia College,446233,"Primarily in person, some courses online",https://ecollege.edu/2020/03/13/coronavirus/,05007,133,Primarily In Person,53,186
Eastern Shore Community College,232052,"Primarily in person, some courses online",https://es.vccs.edu/about-coronavirus-covid-19/,51001,144,Primarily In Person,66,210
Visible Music College,449764,"Primarily in person, some courses online",https://visible.edu/?s=fall+2020,47157,150,Primarily In Person,40,190
Central Christian College of the Bible,176910,"Primarily in person, some courses online",https://cccb.edu/news/covid-19/,29175,162,Primarily In Person,40,202
Dallas Christian College,224244,"Primarily in person, some courses online",https://www.dallas.edu/coronavirus/,48113,167,Primarily In Person,34,201
Mid-Atlantic Christian University,199458,"Primarily in person, some courses online",http://www.macuniversity.edu/news/macus-official-coronavirus-covid-19-update,37139,167,Primarily In Person,39,206
Fort Peck Community College,180212,"Primarily in person, some courses online",http://www.fpcc.edu/wp-content/uploads/COVID-Cummulative-Info.pdf,30085,170,Primarily In Person,80,250
Commonwealth Technical Institute,212975,"Primarily in person, some courses online",https://www.dli.pa.gov/Individuals/Disability-Services/hgac/cti/Pages/default.aspx,42021,174,Primarily In Person,33,207
Gods Bible School and College,202903,"Primarily in person, some courses online",https://www.gbs.edu/covid-19-information/,39061,174,Primarily In Person,69,243
Trinity College of Florida,137962,"Primarily in person, some courses online",https://www.trinitycollege.edu/covid-19/,12101,175,Primarily In Person,37,212
City College-Hollywood,475477,"Primarily in person, some courses online",https://www.citycollege.edu/emergency-notification/,12011,176,Primarily In Person,28,204
Manhattan Christian College,155496,"Primarily in person, some courses online",http://mccks.edu/covid-19-coronavirus-updates/,20161,188,Primarily In Person,55,243
Art Academy of Cincinnati,201061,"Primarily in person, some courses online",http://www.artacademy.edu/student-services/covid.php,39061,191,Primarily In Person,58,249
Luther Rice College & Seminary,135364,"Primarily in person, some courses online",https://www.lutherrice.edu/about-us/covid-19.cms,13089,200,Primarily In Person,42,242
Oregon Coast Community College,423652,"Primarily in person, some courses online",https://oregoncoast.edu/college-coronavirus-response-update/,41041,206,Primarily In Person,67,273
Lancaster County Career and Technology Center,418533,"Primarily in person, some courses online",https://lancasterctc.edu/news/,42071,215,Primarily In Person,171,386
Baptist Bible College,176664,"Primarily in person, some courses online",https://gobbc.edu/?s=covid,29077,218,Primarily In Person,43,261
Mesalands Community College,188261,"Primarily in person, some courses online",https://www.mesalands.edu/category/news-releases/,35037,223,Primarily In Person,64,287
Donnelly College,155007,"Primarily in person, some courses online",https://www.donnelly.edu/updates,20209,226,Primarily In Person,61,287
Little Big Horn College,180328,"Primarily in person, some courses online",https://cloudram.lbhc.edu/ics,30003,226,Primarily In Person,64,290
Bacone College,206817,"Primarily in person, some courses online",https://www.bacone.edu,40101,243,Primarily In Person,56,299
Maria College of Albany,192785,"Primarily in person, some courses online",https://mariacollege.edu/?s=covid,36001,243,Primarily In Person,106,349
Bellin College,238324,"Primarily in person, some courses online",https://www.bellincollege.edu/covid-19-update/,55009,270,Primarily In Person,72,342
Frontier Community College,403469,"Primarily in person, some courses online",https://my.iecc.edu/students/,17191,270,Primarily In Person,66,336
Trinity Baptist College,137953,"Primarily in person, some courses online",https://tbc.edu/news/,12031,284,Primarily In Person,57,341
Flint Hills Technical College,155052,"Primarily in person, some courses online",https://www.fhtc.edu/about/wrangler-newsletter/,20111,287,Primarily In Person,77,364
Randall University,207157,"Primarily in person, some courses online",https://ru.edu/about-randall/news-events/comprehensive-covid-19-statement/,40027,293,Primarily In Person,44,337
Valley Forge Military College,216551,"Primarily in person, some courses online",https://www.vfmac.edu/covid/,42045,306,Primarily In Person,37,343
Sunstate Academy-Jones Technical Institute,487311,"Primarily in person, some courses online",https://www.jtech.org/notifications/,12031,307,Primarily In Person,60,367
Bethany Global University,486284,"Primarily in person, some courses online",https://bethanygu.edu/coronavirus/,27053,310,Primarily In Person,94,404
Riverside College of Health Careers,233408,"Primarily in person, some courses online",https://www.riversideonline.com/covid_19/index.cfm,51700,311,Primarily In Person,53,364
Manhattan Area Technical College,155487,"Primarily in person, some courses online",https://manhattantech.edu/covid19,20161,318,Primarily In Person,77,395
McDowell Technical Community College,198923,"Primarily in person, some courses online",https://www.mcdowelltech.edu/apps/spotlightmessages/3857,37111,325,Primarily In Person,126,451
Calumet College of Saint Joseph,150172,"Primarily in person, some courses online",https://www.ccsj.edu/covid19.php,18089,331,Primarily In Person,102,433
Sweet Briar College,233718,"Primarily in person, some courses online",https://sbc.edu/campus-safety/covid-19/,51009,332,Primarily In Person,194,526
Landmark College,247649,"Primarily in person, some courses online",https://www.landmark.edu/student-life/health-counseling-wellness/covid-19,50025,337,Primarily In Person,204,541
Piedmont Community College,199324,"Primarily in person, some courses online",https://www.piedmontcc.edu/COVID-19,37145,338,Primarily In Person,208,546
University of South Carolina-Union,218706,"Primarily in person, some courses online",https://sc.edu/safety/coronavirus/,45087,345,Primarily In Person,56,401
United Tribes Technical College,200554,"Primarily in person, some courses online",https://uttc.edu/#,38015,370,Primarily In Person,198,568
Finlandia University,172440,"Primarily in person, some courses online",https://www.finlandia.edu/safe-open-fall-2020/,26061,376,Primarily In Person,145,521
Hesston College,155177,"Primarily in person, some courses online",https://www.hesston.edu/covid-19-response/,20079,377,Primarily In Person,116,493
Lamar Community College,127389,"Primarily in person, some courses online",https://www.lamarcc.edu/coronavirus-information/,08099,377,Primarily In Person,87,464
York College,181853,"Primarily in person, some courses online",https://www.york.edu/coronavirus.html,31185,377,Primarily In Person,100,477
Bard College at Simon's Rock,167792,"Primarily in person, some courses online",https://simons-rock.edu/early-college/contact-us/offices-and-departments/wellness-center/wellness-center-update-covid19.php,25003,385,Primarily In Person,206,591
Beacon College,384254,"Primarily in person, some courses online",https://www.beaconcollege.edu/covid-19-information-center/,12069,385,Primarily In Person,142,527
Ohio Valley University,237640,"Primarily in person, some courses online",https://www.ovu.edu/covid19-response,54107,387,Primarily In Person,84,471
Lincoln Trail College,403478,"Primarily in person, some courses online",https://my.iecc.edu/students/,17033,394,Primarily In Person,67,461
Dakota College at Bottineau,200314,"Primarily in person, some courses online",https://www.dakotacollege.edu/explore-dcb/fall-opening,38009,395,Primarily In Person,99,494
Cleveland Institute of Music,202073,"Primarily in person, some courses online",https://www.cim.edu/return-to-campus,39035,396,Primarily In Person,118,514
Allen College,152798,"Primarily in person, some courses online",https://www.allencollege.edu/article.aspx?id=b592408f-5fa4-44e3-8d94-1390e07a07d5&COVID-19+Information+for+Allen+College,19013,406,Primarily In Person,89,495
New Mexico Military Institute,187912,"Primarily in person, some courses online",https://www.nmmi.edu/,35005,412,Primarily In Person,296,708
Mercy College of Health Sciences,153977,"Primarily in person, some courses online",https://www.mchs.edu/Health,19153,415,Primarily In Person,133,548
Glen Oaks Community College,169974,"Primarily in person, some courses online",https://www.glenoaks.edu/coronavirus/,26149,417,Primarily In Person,91,508
Rosedale Technical College,215682,"Primarily in person, some courses online",https://www.rosedaletech.org/coronavirus/,42003,417,Primarily In Person,64,481
Montcalm Community College,171234,"Primarily in person, some courses online",https://www.montcalm.edu/coronavirus,26117,429,Primarily In Person,133,562
Cheyney University of Pennsylvania,211608,"Primarily in person, some courses online",https://cheyney.edu/novel-coronavirus/,42045,433,Primarily In Person,133,566
Lincoln Christian University,146667,"Primarily in person, some courses online",https://lincolnchristian.edu/covid19/coronavirus-covid-19/,17107,434,Primarily In Person,99,533
Villa Maria College,197142,"Primarily in person, some courses online",https://www.villa.edu/coronavirus/,36029,440,Primarily In Person,138,578
Cleary University,169327,"Primarily in person, some courses online",https://www.cleary.edu/coronavirus/,26093,456,Primarily In Person,96,552
Northwest Kansas Technical College,155618,"Primarily in person, some courses online",https://www.nwktc.edu/covid-19,20181,457,Primarily In Person,86,543
Kentucky Christian University,157100,"Primarily in person, some courses online",https://www.kcu.edu/covid-19/,21043,459,Primarily In Person,121,580
Beaufort County Community College,197966,"Primarily in person, some courses online",https://www.beaufortccc.edu/covid-19-faq,37013,461,Primarily In Person,183,644
Wells College,197230,"Primarily in person, some courses online",https://www.wells.edu/news/wells-college-covid-19-response-team,36011,463,Primarily In Person,162,625
Holy Cross College,150774,"Primarily in person, some courses online",https://www.hcc-nd.edu/coronavirus/,18141,469,Primarily In Person,90,559
Cossatot Community College of the University of Arkansas,106795,"Primarily in person, some courses online",https://www.cccua.edu/novel-coronavirus,05133,470,Primarily In Person,132,602
Southeastern Community College,199722,"Primarily in person, some courses online",https://www.scciowa.edu/landing/coronavirus-response-updates.aspx,37047,479,Primarily In Person,249,728
Colorado Northwestern Community College,126748,"Primarily in person, some courses online",https://cncc.edu/covid-19-updates,08103,484,Primarily In Person,128,612
Ozark Christian College,178679,"Primarily in person, some courses online",https://occ.edu/about/covid-response,29097,488,Primarily In Person,112,600
Wabash Valley College,403487,"Primarily in person, some courses online",https://my.iecc.edu/students/,17185,489,Primarily In Person,97,586
Pennsylvania College of Health Sciences,442356,"Primarily in person, some courses online",https://www.pacollege.edu/covid-19-response/,42071,491,Primarily In Person,161,652
Florida College,133809,"Primarily in person, some courses online",https://www.floridacollege.edu/2020/06/01/moving-forward-presidents-message/,12057,494,Primarily In Person,122,616
Prescott College,105589,"Primarily in person, some courses online",https://www.prescott.edu/coronavirus-covid-19-updates,04025,507,Primarily In Person,163,670
Multnomah University,209287,"Primarily in person, some courses online",https://www.multnomah.edu/multnomah-plans-for-fall-2020-2/,41051,513,Primarily In Person,176,689
Independence Community College,155201,"Primarily in person, some courses online",https://www.indycc.edu/alert/1605878/campus-closed-iccs-response-to-coronavirus,20125,516,Primarily In Person,112,628
Wesleyan College,141325,"Primarily in person, some courses online",https://www.wesleyancollege.edu/about/news/Coronavirus/index.cfm,13021,523,Primarily In Person,154,677
Terra State Community College,206011,"Primarily in person, some courses online",http://www.terra.edu/covid19/index.php,39143,533,Primarily In Person,155,688
Western Oklahoma State College,208035,"Primarily in person, some courses online",https://www.wosc.edu/index.php?page=covid19#updates,40065,537,Primarily In Person,131,668
Lake Region State College,200192,"Primarily in person, some courses online",https://www.lrsc.edu/coronavirus-covid-19-preparedness-and-response,38071,538,Primarily In Person,116,654
Northwest Christian University,209409,"Primarily in person, some courses online",https://www.bushnell.edu/covid19/,41039,538,Primarily In Person,133,671
University of South Carolina-Salkehatchie,218681,"Primarily in person, some courses online",https://www.sc.edu/about/system_and_campuses/salkehatchie/about/safety/,45005,538,Primarily In Person,80,618
Blackburn College,143288,"Primarily in person, some courses online",https://blackburn.edu/coronavirus/,17117,548,Primarily In Person,103,651
Eureka College,144971,"Primarily in person, some courses online",https://www.eureka.edu/coronavirus,17203,548,Primarily In Person,117,665
Mitchell College,129774,"Primarily in person, some courses online",https://mitchell.edu/adjusting-our-sails-fall-2020/,09011,553,Primarily In Person,149,702
Northland College,239512,"Primarily in person, some courses online",https://www.northland.edu/news/health-alert/,55003,558,Primarily In Person,136,694
Sterling College,155937,"Primarily in person, some courses online",https://sterlingcollege.edu/coronavirus-2019/,20159,559,Primarily In Person,136,695
Ottawa University-Surprise,464226,"Primarily in person, some courses online",https://www.ottawa.edu/coronavirus/recentupdates,04013,561,Primarily In Person,113,674
Redlands Community College,207069,"Primarily in person, some courses online",https://www.redlandscc.edu/node/4081,40017,567,Primarily In Person,145,712
Western Dakota Technical Institute,219480,"Primarily in person, some courses online",https://www.wdt.edu/future-students/remote-enrollment,46103,568,Primarily In Person,109,677
Erskine College,217998,"Primarily in person, some courses online",https://www.erskine.edu/covid-19/,45001,574,Primarily In Person,131,705
Community Care College,439570,"Primarily in person, some courses online",https://communitycarecollege.edu/news/covid-19-response-update/,40143,578,Primarily In Person,54,632
Otero Junior College,127778,"Primarily in person, some courses online",https://www.ojc.edu/about/policies/emergency/default.aspx,08089,578,Primarily In Person,279,857
Northwest Iowa Community College,154129,"Primarily in person, some courses online",https://nwicc.edu/covid19update/,19167,580,Primarily In Person,148,728
University of South Carolina-Sumter,218690,"Primarily in person, some courses online",https://www.sc.edu/about/offices_and_divisions/human_resources/toolbox/return_to_workplace/return_to_work_plan/index.php,45085,585,Primarily In Person,99,684
Blue Mountain College,175430,"Primarily in person, some courses online",https://bmc.edu/Coronavirus-Information,28139,587,Primarily In Person,114,701
Fond du Lac Tribal and Community College,380368,"Primarily in person, some courses online",https://fdltcc.edu/covid-19-guidelines/,27017,592,Primarily In Person,88,680
Bethany Lutheran College,173142,"Primarily in person, some courses online",https://blc.edu/coronavirus/,27013,593,Primarily In Person,140,733
Cornish College of the Arts,235024,"Primarily in person, some courses online",https://www.cornish.edu/novel-coronavirus-covid-19-information-resources/,53033,617,Primarily In Person,165,782
Asnuntuck Community College,128577,"Primarily in person, some courses online",https://asnuntuck.edu/coronavirus/,09003,621,Primarily In Person,153,774
New Mexico Junior College,187903,"Primarily in person, some courses online",https://www.nmjc.edu/nmjc_announcement/coronavirus.aspx,35025,629,Primarily In Person,269,898
North Central Michigan College,171395,"Primarily in person, some courses online",https://www.ncmich.edu/safety/coronavirus-covid-19.html,26047,646,Primarily In Person,97,743
Capital Community College,129367,"Primarily in person, some courses online",https://www.capitalcc.edu/coronavirus-information/,09003,654,Primarily In Person,206,860
Hannibal-LaGrange University,177542,"Primarily in person, some courses online",https://www.hlg.edu/student-life/coronavirus-covid-19/,29127,672,Primarily In Person,131,803
Itasca Community College,173805,"Primarily in person, some courses online",https://www.itascacc.edu/coronavirus,27061,672,Primarily In Person,80,752
Brevard College,198066,"Primarily in person, some courses online",https://brevard.edu/covid-19-updates/,37175,687,Primarily In Person,226,913
Westminster College,179946,"Primarily in person, some courses online",https://westminstercollege.edu/about/risk-management/coronavirus-covid-19-resources,29027,692,Primarily In Person,156,848
University of South Carolina-Lancaster,218672,"Primarily in person, some courses online",https://sc.edu/safety/coronavirus/,45057,700,Primarily In Person,125,825
Bryan College-Dayton,219790,"Primarily in person, some courses online",https://www.bryan.edu/coronavirus/,47143,705,Primarily In Person,228,933
Cazenovia College,189848,"Primarily in person, some courses online",https://www.cazenovia.edu/coronavirus,36053,708,Primarily In Person,212,920
Columbia International University,217925,"Primarily in person, some courses online",http://www.ciu.edu/covid19#,45079,712,Primarily In Person,270,982
Fisher College,165802,"Primarily in person, some courses online",https://www.fisher.edu/about/updates-on-the-coronavirus,25025,713,Primarily In Person,174,887
Nebraska Methodist College of Nursing & Allied Health,181297,"Primarily in person, some courses online",https://www.methodistcollege.edu/en/background-investigation-0,31055,713,Primarily In Person,138,851
Hilbert College,191621,"Primarily in person, some courses online",https://www.hilbert.edu/about/coronavirus-update,36029,717,Primarily In Person,153,870
Hollins University,232308,"Primarily in person, some courses online",https://www.hollins.edu/coronavirus-preparedness/carefully-onward/,51161,718,Primarily In Person,279,997
Warren Wilson College,199865,"Primarily in person, some courses online",https://www.warren-wilson.edu/wp-content/uploads/2020/07/WWC-COVID-19-Protocols-4.pdf,37021,720,Primarily In Person,197,917
Dakota Wesleyan University,219091,"Primarily in person, some courses online",https://www.dwu.edu/covid-19-information,46035,722,Primarily In Person,170,892
Neosho County Community College,155566,"Primarily in person, some courses online",https://www.neosho.edu/COVID19News.aspx,20133,725,Primarily In Person,214,939
Southwestern Adventist University,228468,"Primarily in person, some courses online",https://www.swau.edu/virusinfo14,48251,725,Primarily In Person,141,866
University of Science and Arts of Oklahoma,207722,"Primarily in person, some courses online",https://usao.edu/about/coronavirus/index.html,40051,728,Primarily In Person,156,884
Thiel College,216357,"Primarily in person, some courses online",https://www.thiel.edu/campus_life/coronavirus-updates,42085,729,Primarily In Person,205,934
Southwest Wisconsin Technical College,239910,"Primarily in person, some courses online",https://www.swtc.edu/news/covid-19-coronavirus/,55043,730,Primarily In Person,217,947
Paul Smiths College of Arts and Science,194392,"Primarily in person, some courses online",https://www.paulsmiths.edu/covid-19/,36033,731,Primarily In Person,158,889
Washington State Community College,206446,"Primarily in person, some courses online",https://www.wscc.edu/coronavirus/,39167,740,Primarily In Person,158,898
Davis & Elkins College,237358,"Primarily in person, some courses online",https://www.dewv.edu/content/davis-elkins-official-responses-regarding-covid-19-0,54083,743,Primarily In Person,184,927
Elmira College,190983,"Primarily in person, some courses online",https://www.elmira.edu/news/stories/16132-elmira-college-announces-plans-for-fall-2020,36015,747,Primarily In Person,215,962
Martin Luther College,173452,"Primarily in person, some courses online",https://mlc-wels.edu/health/coronavirus-information/,27015,752,Primarily In Person,153,905
Lake Erie College,203580,"Primarily in person, some courses online",https://www.lec.edu/covid-19-coronavirus-information,39085,755,Primarily In Person,180,935
Moraine Park Technical College,239372,"Primarily in person, some courses online",https://www.morainepark.edu/coronavirus,55039,755,Primarily In Person,446,1201
Union College,181738,"Primarily in person, some courses online",https://www.unionky.edu/departments/college-communications/covid-19,31109,759,Primarily In Person,204,963
Hacienda La Puente Adult Education,383084,"Primarily in person, some courses online",https://www.hlpae.com/,06037,760,Primarily In Person,60,820
University of Connecticut-Waterbury Campus,436818,"Primarily in person, some courses online",https://reopen.uconn.edu/,09009,769,Primarily In Person,87,856
Seward County Community College,155858,"Primarily in person, some courses online",https://scccnews.com/category/covid-19-response/,20175,782,Primarily In Person,221,1003
Cloud County Community College,154907,"Primarily in person, some courses online",https://www.cloud.edu/about/covid19-news,20029,789,Primarily In Person,205,994
Greensboro College,198598,"Primarily in person, some courses online",https://www.greensboro.edu/health-services/coronavirus/,37081,794,Primarily In Person,170,964
Judson University,146339,"Primarily in person, some courses online",https://www.judsonu.edu/coronavirus/,17089,805,Primarily In Person,193,998
Treasure Valley Community College,210234,"Primarily in person, some courses online",https://www.tvcc.cc/news/coronavirus.cfm,41045,807,Primarily In Person,192,999
Cairn University-Langhorne,215114,"Primarily in person, some courses online",https://cairn.edu/covid19/,42017,811,Primarily In Person,199,1010
Blackhawk Technical College,238397,"Primarily in person, some courses online",https://www.blackhawk.edu/Coronavirus,55105,820,Primarily In Person,333,1153
Goshen College,150668,"Primarily in person, some courses online",https://www.goshen.edu/emergency/coronavirus/,18039,821,Primarily In Person,231,1052
Lamar State College-Orange,226107,"Primarily in person, some courses online",http://www.lsco.edu/news/novel-coronavirus-2019-ncov.asp,48361,821,Primarily In Person,148,969
Colby-Sawyer College,182634,"Primarily in person, some courses online",https://colby-sawyer.edu/coronavirus,33013,822,Primarily In Person,255,1077
Drury University-College of Continuing Professional Studies,492801,"Primarily in person, some courses online",https://www.drury.edu/go,29077,822,Primarily In Person,105,927
Highland Community College,145521,"Primarily in person, some courses online",https://highlandcc.edu/pages/covid-19,17177,822,Primarily In Person,184,1006
William Peace University,199272,"Primarily in person, some courses online",https://peace.edu/covid-19-info-center/,37183,832,Primarily In Person,166,998
Thomas College,161563,"Primarily in person, some courses online",https://www.thomas.edu/coronavirus/,23011,833,Primarily In Person,161,994
Howard Payne University,225548,"Primarily in person, some courses online",https://www.hputx.edu/covid-19-information/,48049,835,Primarily In Person,219,1054
Millsaps College,175980,"Primarily in person, some courses online",http://www.millsaps.edu/coronavirus/index.php,28049,845,Primarily In Person,259,1104
Alderson Broaddus University,237118,"Primarily in person, some courses online",https://ab.edu/coronavirus/,54001,859,Primarily In Person,207,1066
Columbia College,217934,"Primarily in person, some courses online",https://www.ccis.edu/information/covid-19.aspx,45079,870,Primarily In Person,182,1052
Chipola College,133021,"Primarily in person, some courses online",http://www.chipola.edu/help/FAQ.htm,12063,876,Primarily In Person,188,1064
Southwestern Michigan College,172307,"Primarily in person, some courses online",https://www.swmich.edu/coronavirus,26027,880,Primarily In Person,192,1072
University of Saint Mary,155812,"Primarily in person, some courses online",https://www.stmary.edu/coronavirus-information,20103,880,Primarily In Person,238,1118
Wabash College,152673,"Primarily in person, some courses online",https://www.wabash.edu/covid/,18107,881,Primarily In Person,276,1157
Seminole State College,207740,"Primarily in person, some courses online",https://www.sscok.edu/covid19/covid.html,40133,882,Primarily In Person,154,1036
Fort Scott Community College,155098,"Primarily in person, some courses online",http://www.fortscott.edu/node/2399,20011,883,Primarily In Person,170,1053
Barton County Community College,154697,"Primarily in person, some courses online",https://bartonccc.edu/covid19,20009,890,Primarily In Person,359,1249
Toccoa Falls College,141185,"Primarily in person, some courses online",https://tfc.edu/news/tfc-covid-19-update-to-current-students/,13257,890,Primarily In Person,175,1065
John Wood Community College,146278,"Primarily in person, some courses online",https://info.jwcc.edu/coronavirus,17001,896,Primarily In Person,215,1111
Tennessee Wesleyan University,221731,"Primarily in person, some courses online",https://www.tnwesleyan.edu/news/reopeningplans.php,47107,897,Primarily In Person,151,1048
William Woods University,179964,"Primarily in person, some courses online",https://www.williamwoods.edu/emergency-info/index.html,29027,899,Primarily In Person,295,1194
Greenville University,145372,"Primarily in person, some courses online",https://www.greenville.edu/about/emergency-communications/gu-alert.html,17005,900,Primarily In Person,232,1132
Black River Technical College,106625,"Primarily in person, some courses online",http://www.blackrivertech.org/brtcstudents/campus-health,05121,902,Primarily In Person,174,1076
Quincy University,148131,"Primarily in person, some courses online",https://www.quincy.edu/coronavirus/,17001,905,Primarily In Person,177,1082
Georgetown College,156745,"Primarily in person, some courses online",http://www.georgetowncollege.edu/tigers-together,21209,912,Primarily In Person,287,1199
Grace Christian University,170000,"Primarily in person, some courses online",https://gracechristian.edu/coronavirus,26081,913,Primarily In Person,147,1060
Lees-McRae College,198808,"Primarily in person, some courses online",https://www.lmc.edu/campus-life/security/coronavirus.htm,37011,915,Primarily In Person,170,1085
Trinity International University-Illinois,149514,"Primarily in person, some courses online",https://www.tiu.edu/trinity-coronavirus-covid-19-information/,17097,925,Primarily In Person,251,1176
Woodland Community College,455512,"Primarily in person, some courses online",https://wcc.yccd.edu/remote-instruction/covid-19-faqs/,06113,927,Primarily In Person,123,1050
Averett University,231420,"Primarily in person, some courses online",https://www.averett.edu/academics/registrars-office/catalogs/,51590,930,Primarily In Person,209,1139
Fontbonne University,177418,"Primarily in person, some courses online",https://www.fontbonne.edu/student-life/student-services/counseling-wellness/coronavirus-covid-19/,29189,930,Primarily In Person,234,1164
Franklin College,150604,"Primarily in person, some courses online",https://franklincollege.edu/coronavirus/,18081,931,Primarily In Person,270,1201
Vernon College,229504,"Primarily in person, some courses online",https://www.vernoncollege.edu/coronavirus-updates,48487,932,Primarily In Person,248,1180
Olivet College,171599,"Primarily in person, some courses online",https://www.olivetcollege.edu/about/occares/,26045,933,Primarily In Person,182,1115
Southern Virginia University,233611,"Primarily in person, some courses online",https://svu.edu/covid-19/,51530,935,Primarily In Person,207,1142
Converse College,217961,"Primarily in person, some courses online",https://www.converse.edu/coronavirus-updates/,45083,939,Primarily In Person,212,1151
Mountain Empire Community College,232788,"Primarily in person, some courses online",https://www.mecc.edu/coronavirus/,51195,944,Primarily In Person,172,1116
LaGrange College,140234,"Primarily in person, some courses online",https://www.lagrange.edu/about/coronavirus/index.html,13285,948,Primarily In Person,200,1148
Corban University,210331,"Primarily in person, some courses online",https://www.corban.edu/student-life/health-resources/coronavirus-f-a-q/,41047,949,Primarily In Person,181,1130
Southwestern Oregon Community College,210155,"Primarily in person, some courses online",https://mylakerlink.socc.edu/ICS/Administrative_Services/,41011,949,Primarily In Person,278,1227
Pfeiffer University,199306,"Primarily in person, some courses online",https://www.pfeiffer.edu/cares-act-public-notice,37167,950,Primarily In Person,203,1153
Rocky Mountain College,180595,"Primarily in person, some courses online",https://www.rocky.edu/coronavirus,30111,956,Primarily In Person,229,1185
Northwestern College,154101,"Primarily in person, some courses online",https://www.nwciowa.edu/wellness/coronavirus/fall-2020,19167,961,Primarily In Person,256,1217
Concordia University-Ann Arbor,169363,"Primarily in person, some courses online",https://www.cuaa.edu/landingpages/covid19/index.html,26161,962,Primarily In Person,202,1164
Eastern New Mexico University-Roswell Campus,187666,"Primarily in person, some courses online",https://www.roswell.enmu.edu/enmu-roswell-coronavirus-response/,35005,972,Primarily In Person,231,1203
Barton College,197911,"Primarily in person, some courses online",https://www.barton.edu/coronavirus/,37195,973,Primarily In Person,239,1212
Eastern Mennonite University,232043,"Primarily in person, some courses online",https://emu.edu/coronavirus/fall-faq,51660,975,Primarily In Person,321,1296
Illinois College,145691,"Primarily in person, some courses online",https://www.ic.edu/coronavirus,17137,976,Primarily In Person,255,1231
Midway University,157377,"Primarily in person, some courses online",https://www.midway.edu/coronavirus/,21239,981,Primarily In Person,154,1135
Cardinal Stritch University,238430,"Primarily in person, some courses online",https://www.stritch.edu/landing-pages/university-alert-landing-pages/covid-19,55079,983,Primarily In Person,269,1252
Young Harris College,141361,"Primarily in person, some courses online",https://www.yhc.edu/about/news-media/press-room,13281,984,Primarily In Person,193,1177
Bluefield State College,237215,"Primarily in person, some courses online",https://bluefieldstate.edu/homepage/covid-19,54055,985,Primarily In Person,163,1148
Emory University-Oxford College,487092,"Primarily in person, some courses online",http://www.oxford.emory.edu/resources/oxford-forward/index.html,13217,990,Primarily In Person,229,1219
Manhattan School of Music,192712,"Primarily in person, some courses online",https://www.msmnyc.edu/about/fall-2020-reopening/,36061,1004,Primarily In Person,303,1307
Covenant College,139393,"Primarily in person, some courses online",https://www.covenant.edu/covid19,13083,1008,Primarily In Person,219,1227
Anna Maria College,164492,"Primarily in person, some courses online",https://www.annamaria.edu/covid-19,25027,1012,Primarily In Person,212,1224
Glenville State College,237385,"Primarily in person, some courses online",https://www.glenville.edu/emergency/COVID-19,54021,1013,Primarily In Person,221,1234
Logan University,177986,"Primarily in person, some courses online",https://www.logan.edu/healthupdate/,29189,1014,Primarily In Person,232,1246
Wayland Baptist University,229780,"Primarily in person, some courses online",https://www.wbu.edu/notification.htm,48189,1014,Primarily In Person,596,1610
Immaculata University,213011,"Primarily in person, some courses online",https://www.immaculata.edu/coronavirus-covid-19-updates/,42029,1018,Primarily In Person,330,1348
Potomac State College of West Virginia University,237701,"Primarily in person, some courses online",https://www.wvu.edu/return-to-campus,54057,1018,Primarily In Person,169,1187
Pierpont Community and Technical College,443492,"Primarily in person, some courses online",https://www.pierpont.edu/coronavirus,54049,1022,Primarily In Person,139,1161
Lourdes University,203757,"Primarily in person, some courses online",https://www.lourdes.edu/campus-life/coronavirus/,39095,1028,Primarily In Person,193,1221
Mount Aloysius College,214166,"Primarily in person, some courses online",https://www.mtaloy.edu/coronavirus/,42021,1028,Primarily In Person,220,1248
Friends University,155089,"Primarily in person, some courses online",https://www.friends.edu/student-life/wellness-therapy/health-wellness-center/coronavirus/,20173,1031,Primarily In Person,274,1305
University of North Carolina School of the Arts,199184,"Primarily in person, some courses online",https://www.uncsa.edu/mysa/plan/index.aspx,37067,1035,Primarily In Person,497,1532
College of Saint Mary,181604,"Primarily in person, some courses online",https://www.csm.edu/fall-semester-2020,31055,1037,Primarily In Person,210,1247
Arkansas State University-Newport,440402,"Primarily in person, some courses online",https://www.asun.edu/coronavirus,05067,1039,Primarily In Person,204,1243
Southern West Virginia Community and Technical College,237817,"Primarily in person, some courses online",https://www.southernwv.edu/coronavirus/#update-from-president-alderman,54045,1048,Primarily In Person,162,1210
University of Jamestown,200156,"Primarily in person, some courses online",https://www.uj.edu/university-news?id=48413,38093,1061,Primarily In Person,211,1272
Lancaster Bible College,213400,"Primarily in person, some courses online",https://www.lbc.edu/campusupdates/,42071,1070,Primarily In Person,279,1349
Columbus Technical College,139357,"Primarily in person, some courses online",https://www.columbustech.edu/covid-19.cms,13215,1073,Primarily In Person,270,1343
Earlham College,150455,"Primarily in person, some courses online",https://earlham.edu/coronavirus/,18177,1074,Primarily In Person,349,1423
Central College,153108,"Primarily in person, some courses online",https://www.central.edu/health/covid19-archive/coronavirus-updates/,19125,1077,Primarily In Person,390,1467
Western Wyoming Community College,240693,"Primarily in person, some courses online",https://www.westernwyoming.edu/_resources/coronavirus.php,56037,1096,Primarily In Person,351,1447
Hanover College,150756,"Primarily in person, some courses online",https://www.hanover.edu/coronavirus/backtohanover,18077,1097,Primarily In Person,257,1354
Bethel College-Indiana,150145,"Primarily in person, some courses online",https://www.betheluniversity.edu/intheknow,18141,1102,Primarily In Person,245,1347
Maryville College,220710,"Primarily in person, some courses online",https://www.maryvillecollege.edu/news/info-regarding-covid19/,47009,1102,Primarily In Person,312,1414
The Master's University and Seminary,117751,"Primarily in person, some courses online",https://www.masters.edu/coronavirus,06037,1103,Primarily In Person,310,1413
University of Rio Grande,205203,"Primarily in person, some courses online",https://www.rio.edu/coronavirus/,39053,1104,Primarily In Person,211,1315
Rivier University,183211,"Primarily in person, some courses online",https://www.rivier.edu/student-life/health-and-wellness/health-alert-coronavirus-covoid-19/,33011,1108,Primarily In Person,354,1462
Ohio Dominican University,204617,"Primarily in person, some courses online",https://www.ohiodominican.edu/current-students/student-life/health-wellness-/coronavirus-information-resources,39049,1114,Primarily In Person,227,1341
Heidelberg University,203085,"Primarily in person, some courses online",https://www.heidelberg.edu/studentlife/health-and-safety/covid-19-novel-coronavirus,39147,1116,Primarily In Person,270,1386
Point University,138868,"Primarily in person, some courses online",https://point.edu/consumerinformation/coronavirus/,13285,1116,Primarily In Person,236,1352
Baker University,154688,"Primarily in person, some courses online",https://www.bakeru.edu/coronavirus/,20045,1119,Primarily In Person,348,1467
Huntington University,150941,"Primarily in person, some courses online",,18069,1124,Primarily In Person,205,1329
Otis College of Art and Design,120403,"Primarily in person, some courses online",https://www.otis.edu/otis-forward,06037,1125,Primarily In Person,401,1526
Athens Technical College,246813,"Primarily in person, some courses online",https://www.athenstech.edu/atcInfo/campusSafety/COVID-19/,13059,1130,Primarily In Person,361,1491
Lycoming College,213668,"Primarily in person, some courses online",,42081,1135,Primarily In Person,307,1442
Shorter University,140988,"Primarily in person, some courses online",https://www.shorter.edu/covid-19-preventative-measures-and-protocol-for-fall-semester-2020/,13115,1137,Primarily In Person,236,1373
Peru State College,181534,"Primarily in person, some courses online",https://www.peru.edu/media/coronavirus,31127,1140,Primarily In Person,198,1338
Garden City Community College,155104,"Primarily in person, some courses online",https://www.gcccks.edu/covid-19/default.aspx#statement,20055,1144,Primarily In Person,253,1397
Coker College,217907,"Primarily in person, some courses online",https://www.coker.edu/offices-services/campus-safety/alerts/covid-19-information-and-faq/,45031,1145,Primarily In Person,192,1337
Northeast Iowa Community College,154110,"Primarily in person, some courses online",https://www.nicc.edu/about/consumer-information/coronavirus/,19191,1153,Primarily In Person,455,1608
Alexandria Technical & Community College,172918,"Primarily in person, some courses online",https://www.alextech.edu/about-atcc/safety-security/covid-19,27041,1165,Primarily In Person,139,1304
Wilmington College,206507,"Primarily in person, some courses online",https://www.wilmington.edu/about/covid-19/,39027,1165,Primarily In Person,207,1372
Central Louisiana Technical Community College,158088,"Primarily in person, some courses online",https://www.cltcc.edu/alert/1605733/coronavirus-update,22079,1168,Primarily In Person,153,1321
Panola College,227386,"Primarily in person, some courses online",,48365,1169,Primarily In Person,192,1361
Westminster College,216807,"Primarily in person, some courses online",https://www.westminster.edu/campus/health/covid19/,42073,1170,Primarily In Person,262,1432
Miami University-Middletown,204015,"Primarily in person, some courses online",https://miamioh.edu/coronavirus/,39017,1171,Primarily In Person,193,1364
West Virginia University Institute of Technology,237950,"Primarily in person, some courses online",https://www.wvu.edu/return-to-campus,54081,1175,Primarily In Person,239,1414
The University of Montana-Western,180692,"Primarily in person, some courses online",https://w.umwestern.edu/section/health-advisories/,30001,1177,Primarily In Person,198,1375
Albertus Magnus College,128498,"Primarily in person, some courses online",https://www.albertus.edu/returntocampus/,09009,1182,Primarily In Person,309,1491
Patrick Henry Community College,233019,"Primarily in person, some courses online",https://www.patrickhenry.edu/students/1775-coronavirus-updates-2-sub-statement-on-covid-19,51089,1183,Primarily In Person,222,1405
Schreiner University,228042,"Primarily in person, some courses online",https://schreiner.edu/covid-19-update/,48265,1186,Primarily In Person,255,1441
Newberry College,218414,"Primarily in person, some courses online",https://www.newberry.edu/returning,45071,1190,Primarily In Person,211,1401
Carroll College,180106,"Primarily in person, some courses online",https://www.carroll.edu/marching-back-covid-19/covid-19-resources-updates,30049,1201,Primarily In Person,229,1430
State Technical College of Missouri,177977,"Primarily in person, some courses online",https://www.statetechmo.edu/covid-19/,29151,1213,Primarily In Person,188,1401
Mount Mercy University,154013,"Primarily in person, some courses online",https://www.mtmercy.edu/campus-life/health-wellness/coronavirus/index,19113,1216,Primarily In Person,267,1483
East Central College,177250,"Primarily in person, some courses online",https://www.eastcentral.edu/covid/,29071,1219,Primarily In Person,245,1464
St. Thomas Aquinas College,195243,"Primarily in person, some courses online",https://www.stac.edu/most-recent-coronavirus-updates,36087,1229,Primarily In Person,216,1445
Geneva College,212656,"Primarily in person, some courses online",https://www.geneva.edu/emergency/coronavirus/,42007,1232,Primarily In Person,269,1501
Presbyterian College,218539,"Primarily in person, some courses online",https://www.presby.edu/campus-life/campus-health-notice-novel-coronavirus/,45059,1240,Primarily In Person,321,1561
Morningside College,154004,"Primarily in person, some courses online",https://www.morningside.edu/campus-life-and-arts/campus-safety/morningside-health-update-coronavirus-covid-19/,19193,1241,Primarily In Person,300,1541
Marian University,239080,"Primarily in person, some courses online",https://www.marianuniversity.edu/about/how-were-responding-to-coronavirus-related-concerns/,55039,1245,Primarily In Person,222,1467
Renton Technical College,236382,"Primarily in person, some courses online",https://www.rtc.edu/coronavirus,53033,1245,Primarily In Person,257,1502
Midland University,181330,"Primarily in person, some courses online",https://drive.google.com/file/d/1LKpra7ftg8t3-FJ3rDmJ5q8bifif_XU0/view,31053,1248,Primarily In Person,273,1521
Nichols College,167260,"Primarily in person, some courses online",https://www.nichols.edu/coronavirus,25027,1249,Primarily In Person,231,1480
University of Mobile,101693,"Primarily in person, some courses online",https://umobile.edu/coronavirus/,01097,1252,Primarily In Person,222,1474
Simpson College,154350,"Primarily in person, some courses online",https://simpson.edu/covid19/,19181,1260,Primarily In Person,281,1541
Birmingham Southern College,100937,"Primarily in person, some courses online",https://www.bsc.edu/emergency/index.html,01073,1261,Primarily In Person,318,1579
LDS Business College,230418,"Primarily in person, some courses online",http://www.slcc.edu/safe/c19.aspx,49035,1267,Primarily In Person,151,1418
Florida Polytechnic University,482936,"Primarily in person, some courses online",https://weeklyphoenix.floridapoly.edu/notice/dont-forget-to-visit-florida-polys-covid-19-website/,12105,1271,Primarily In Person,249,1520
Virginia Wesleyan University,234173,"Primarily in person, some courses online",https://www.vwu.edu/coronavirus/index.php,51810,1279,Primarily In Person,261,1540
Siena Heights University,172264,"Primarily in person, some courses online",http://accessibility.sienaheights.edu/covid-19-resources.html,26091,1280,Primarily In Person,321,1601
Grays Harbor College,235334,"Primarily in person, some courses online",https://www.ghc.edu/covid19,53027,1283,Primarily In Person,179,1462
Caldwell Community College and Technical Institute,198118,"Primarily in person, some courses online",https://www.cccti.edu/COVID-19/Default.asp,37027,1284,Primarily In Person,395,1679
Austin College,222983,"Primarily in person, some courses online",https://www.austincollege.edu/campus-life/health-services/monitoring-the-coronavirus/,48181,1295,Primarily In Person,289,1584
University of Connecticut-Hartford Campus,463056,"Primarily in person, some courses online",https://reopen.uconn.edu/,09003,1300,Primarily In Person,174,1474
Texas A&M University-Texarkana,224545,"Primarily in person, some courses online",https://tamut.edu/About/Administration/COVID_19/index.html,48037,1306,Primarily In Person,280,1586
Sussex County Community College,247603,"Primarily in person, some courses online",https://www.sussex.edu/community/covid-19-information/,34037,1318,Primarily In Person,226,1544
Lubbock Christian University,226383,"Primarily in person, some courses online",https://lcu.edu/resources/health-and-safety/medical-clinic/coronavirus/,48303,1324,Primarily In Person,325,1649
Linfield College-McMinnville Campus,209065,"Primarily in person, some courses online",https://www.linfield.edu/coronavirus-update.html,41071,1334,Primarily In Person,314,1648
Texas Lutheran University,228981,"Primarily in person, some courses online",https://www.tlu.edu/about-tlu/covid-19-planning-response,48187,1362,Primarily In Person,242,1604
Southern Crescent Technical College,139986,"Primarily in person, some courses online",https://www.sctech.edu/covid-19/,13255,1363,Primarily In Person,338,1701
Waynesburg University,216694,"Primarily in person, some courses online",https://www.waynesburg.edu/keep-waynesburg-well,42059,1365,Primarily In Person,300,1665
Anderson University,150066,"Primarily in person, some courses online",https://andersonuniversity.edu/campus-life/thrive-wellness/covid-19,18095,1367,Primarily In Person,345,1712
Mary Baldwin University,232672,"Primarily in person, some courses online",https://marybaldwin.edu/backtobaldwin/,51790,1371,Primarily In Person,433,1804
LeTourneau University,226231,"Primarily in person, some courses online",https://www.letu.edu/coronavirus.html,48183,1376,Primarily In Person,415,1791
Northwestern Michigan College,171483,"Primarily in person, some courses online",https://www.nmc.edu/student-services/health-services/corona-virus/index.html,26055,1381,Primarily In Person,437,1818
Coe College,153144,"Primarily in person, some courses online",https://www.coe.edu/student-life/student-life-resources/health-wellness/covid-19,19113,1392,Primarily In Person,335,1727
Guilford College,198613,"Primarily in person, some courses online",https://www.guilford.edu/news/2020/06/guilford-college-announces-reopening-plan-fall-2020,37081,1393,Primarily In Person,349,1742
Butler County Community College,211343,"Primarily in person, some courses online",https://bc3.edu/services/coronavirus-2019.html,42019,1395,Primarily In Person,342,1737
Northeast Texas Community College,227225,"Primarily in person, some courses online",https://www.ntcc.edu/about-us/marketing-public-information/ntcc-response-covid-19-coronavirus,48449,1395,Primarily In Person,255,1650
Alma College,168591,"Primarily in person, some courses online",https://www.alma.edu/coronavirus-updates/,26057,1397,Primarily In Person,291,1688
Harris-Stowe State University,177551,"Primarily in person, some courses online",http://go.hssu.edu/rsp_content.cfm?wid=74&pid=1845&CFID=9471157&CFTOKEN=77580075,29510,1398,Primarily In Person,198,1596
Southeast Technical Institute,219426,"Primarily in person, some courses online",https://southeasttech.edu/coronavirus/returning-to-campus.php,46099,1405,Primarily In Person,231,1636
Ursinus College,216524,"Primarily in person, some courses online",https://www.ursinus.edu/offices/wellness-center/covid-19-coronavirus/,42091,1408,Primarily In Person,400,1808
North Iowa Area Community College,154059,"Primarily in person, some courses online",https://www.niacc.edu/about/coronavirus-information/,19033,1412,Primarily In Person,292,1704
Missouri Valley College,178369,"Primarily in person, some courses online",https://www.moval.edu/news-events/mvc-update-on-coronavirus-covid-19/,29195,1413,Primarily In Person,236,1649
Southwestern University,228343,"Primarily in person, some courses online",https://www.southwestern.edu/reopening/,48491,1416,Primarily In Person,420,1836
Cayuga County Community College,189839,"Primarily in person, some courses online",https://www.cayuga-cc.edu/,36011,1420,Primarily In Person,243,1663
Centre College,156408,"Primarily in person, some courses online",https://tigernet.campbellsville.edu/ICS/Academic_Affairs/Academic_Office/Course_Offerings.jnz?portlet=Simple_Query_2016-06-18T05-56-46-583,21021,1433,Primarily In Person,444,1877
Northern Wyoming Community College District,240666,"Primarily in person, some courses online",https://www.sheridan.edu/updates/#1591040987385-942c5460-0683,56033,1434,Primarily In Person,382,1816
Sul Ross State University,228501,"Primarily in person, some courses online",https://srinfo.sulross.edu/covid-19/,48043,1439,Primarily In Person,401,1840
Belmont Abbey College,197984,"Primarily in person, some courses online",https://www.belmontabbeycollege.edu/coronavirus/,37071,1440,Primarily In Person,238,1678
Davidson County Community College,198376,"Primarily in person, some courses online",https://www.davidsonccc.edu/coronavirus-response/,37057,1446,Primarily In Person,398,1844
Cowley County Community College,154952,"Primarily in person, some courses online",https://www.cowley.edu/covid-19/index.html,20035,1449,Primarily In Person,231,1680
Wartburg College,154527,"Primarily in person, some courses online",https://www.wartburg.edu/coronavirus/,19017,1456,Primarily In Person,364,1820
Manchester University,151777,"Primarily in person, some courses online",https://www.manchester.edu/student-life/health-and-sports-medicine/medical-alerts,18169,1459,Primarily In Person,324,1783
Mansfield University of Pennsylvania,213783,"Primarily in person, some courses online",https://www.mansfield.edu/alerts/coronavirus.cfm,42117,1462,Primarily In Person,320,1782
Miles College,101675,"Primarily in person, some courses online",https://www.miles.edu/coronavirus-updates/0/Coronavirus-Updates,01073,1470,Primarily In Person,277,1747
Graceland University-Lamoni,153366,"Primarily in person, some courses online",https://www.graceland.edu/covid-19,19053,1472,Primarily In Person,286,1758
Southwestern Assemblies of God University,228325,"Primarily in person, some courses online",https://www.sagu.edu/landing-pages/covid19,48139,1472,Primarily In Person,249,1721
Tusculum University,221953,"Primarily in person, some courses online",https://home.tusculum.edu/,47059,1472,Primarily In Person,324,1796
Gateway Technical College,238759,"Primarily in person, some courses online",https://www.gtc.edu/coronavirus-covid-19,55059,1495,Primarily In Person,761,2256
Saint Mary's College,152390,"Primarily in person, some courses online",https://www.saintmarys.edu/live-learn-work,18141,1497,Primarily In Person,444,1941
Oakwood University,101912,"Primarily in person, some courses online",https://www2.oakwood.edu/oakwood-university-coronavirus-covid-19-update/,01089,1502,Primarily In Person,304,1806
Texarkana College,228699,"Primarily in person, some courses online",https://www.texarkanacollege.edu/coronavirus/,48037,1516,Primarily In Person,266,1782
Christian Brothers University,219833,"Primarily in person, some courses online",https://www.cbu.edu/coronavirus,47157,1525,Primarily In Person,318,1843
Brenau University,139199,"Primarily in person, some courses online",https://www.brenau.edu/coronavirus/,13139,1528,Primarily In Person,391,1919
Keuka College,192192,"Primarily in person, some courses online",https://www.keuka.edu/coronavirus,36123,1532,Primarily In Person,285,1817
College of the Ozarks,178697,"Primarily in person, some courses online",https://www.cofo.edu/Novel-Coronavirus-COVID-19,29213,1533,Primarily In Person,368,1901
St. Mary's College of Maryland,163912,"Primarily in person, some courses online",https://www.smcm.edu/reopening-smcm/,24037,1533,Primarily In Person,418,1951
Madonna University,170806,"Primarily in person, some courses online",https://www.madonna.edu/coronavirus/,26163,1545,Primarily In Person,371,1916
Ohio Wesleyan University,204909,"Primarily in person, some courses online",https://www.owu.edu/about/safe-campus-guide-covid-19/monitoring-your-health/about-covid-19-coronavirus/,39041,1547,Primarily In Person,427,1974
Lake Area Technical Institute,219143,"Primarily in person, some courses online",https://www.lakeareatech.edu/covid-19/,46029,1566,Primarily In Person,208,1774
Northshore Technical Community College,160667,"Primarily in person, some courses online",https://www.northshorecollege.edu/updates,22103,1588,Primarily In Person,203,1791
College of Mount Saint Vincent,193399,"Primarily in person, some courses online",https://mountsaintvincent.edu/information-on-coronavirus-covid-19/,36005,1606,Primarily In Person,357,1963
University of St Francis,148584,"Primarily in person, some courses online",https://www.stfrancis.edu/emergency-alerts/,17197,1611,Primarily In Person,385,1996
Southeastern Baptist Theological Seminary,199759,"Primarily in person, some courses online",,37183,1614,Primarily In Person,309,1923
Grand View University,153375,"Primarily in person, some courses online",https://www.grandview.edu/about/institutional-information/planning-for-fall-2020,19153,1619,Primarily In Person,291,1910
SUNY Maritime College,196291,"Primarily in person, some courses online",http://www.sunymaritime.edu/maritime-college-coronavirus-covid-19-update,36005,1619,Primarily In Person,308,1927
Bryn Mawr College,211273,"Primarily in person, some courses online",https://www.brynmawr.edu/coronavirus,42091,1632,Primarily In Person,623,2255
Elizabethtown College,212197,"Primarily in person, some courses online",https://www.etown.edu/covid/covid_19.aspx,42071,1641,Primarily In Person,502,2143
Wofford College,218973,"Primarily in person, some courses online",https://www.wofford.edu/coronavirus,45083,1653,Primarily In Person,455,2108
Oklahoma State University Institute of Technology,207564,"Primarily in person, some courses online",https://osuit.edu/coronavirus/index.php,40111,1665,Primarily In Person,321,1986
Meredith College,198950,"Primarily in person, some courses online",https://www.meredith.edu/staying-strong,37183,1666,Primarily In Person,458,2124
Lake Superior State University,170639,"Primarily in person, some courses online",https://www.lssu.edu/coronavirus/,26033,1669,Primarily In Person,347,2016
Northwest Nazarene University,142461,"Primarily in person, some courses online",https://www.nnu.edu/covid-19,16027,1673,Primarily In Person,317,1990
Piedmont College,140818,"Primarily in person, some courses online",https://www.piedmont.edu/coronavirus,13137,1676,Primarily In Person,418,2094
Concord University,237330,"Primarily in person, some courses online",https://www.concord.edu/About/Return-to-Campus-Plan.aspx,54055,1684,Primarily In Person,268,1952
Louisiana State University-Eunice,159407,"Primarily in person, some courses online",https://www.lsue.edu/eoc/coronavirus.php,22001,1684,Primarily In Person,183,1867
Virginia Military Institute,234085,"Primarily in person, some courses online",https://www.vmi.edu/cadet-life/health-and-safety/coronavirus-updates/,51678,1685,Primarily In Person,606,2291
North Carolina Wesleyan College,199209,"Primarily in person, some courses online",https://ncwc.edu/alerts/,37127,1696,Primarily In Person,292,1988
University of Saint Francis-Fort Wayne,152336,"Primarily in person, some courses online",https://news.sf.edu/category/coronavirus?_ga=2.71590483.170080369.1594139572-1376671110.1594139572,18003,1696,Primarily In Person,390,2086
University of Connecticut-Stamford,436836,"Primarily in person, some courses online",https://reopen.uconn.edu/,09001,1701,Primarily In Person,87,1788
Massachusetts Maritime Academy,166692,"Primarily in person, some courses online",https://www.maritime.edu/covid-19-updates-resources-and-information,25001,1707,Primarily In Person,298,2005
Nebraska Wesleyan University,181446,"Primarily in person, some courses online",https://www.nebrwesleyan.edu/about-nwu/covid-19-coronavirus-updates,31109,1714,Primarily In Person,362,2076
Northern Vermont University,230913,"Primarily in person, some courses online",https://www.northernvermont.edu/about/nvu/coronavirus-covid-19,50015,1717,Primarily In Person,311,2028
Saint Michael's College,231059,"Primarily in person, some courses online",https://www.smcvt.edu/return-to-campus/,50007,1725,Primarily In Person,390,2115
Alfred University,188641,"Primarily in person, some courses online",https://my.alfred.edu/special-announcement/index.cfm,36003,1727,Primarily In Person,573,2300
Mount Vernon Nazarene University,204194,"Primarily in person, some courses online",https://www.mvnu.edu/stayinformed,39083,1728,Primarily In Person,405,2133
Mississippi Delta Community College,176008,"Primarily in person, some courses online",https://www.msdelta.edu/news-room/covid19.php,28133,1731,Primarily In Person,277,2008
Lebanon Valley College,213507,"Primarily in person, some courses online",http://wordpress.lvc.edu/wordpress/lvcforward/,42075,1746,Primarily In Person,388,2134
Mid-America Christian University,245953,"Primarily in person, some courses online",https://www.macu.edu/coronavirus-updates,40027,1750,Primarily In Person,267,2017
Central Carolina Community College,198251,"Primarily in person, some courses online",https://www.cccc.edu/homepageDetails/2020/coronavirus/,37105,1753,Primarily In Person,626,2379
Augustana University,219000,"Primarily in person, some courses online",http://www.augie.edu/coronavirus-covid-19-information-and-resources,46099,1754,Primarily In Person,421,2175
Paris Junior College,227401,"Primarily in person, some courses online",https://www.parisjc.edu/index.php/pjc2/main/coronavirus-and-pjc/,48277,1765,Primarily In Person,257,2022
Eastern Oregon University,208646,"Primarily in person, some courses online",https://www.eou.edu/coronavirus/,41061,1767,Primarily In Person,367,2134
Franklin Pierce University,182795,"Primarily in person, some courses online",https://www.franklinpierce.edu/about/coronavirus/index.htm,33005,1767,Primarily In Person,361,2128
Adrian College,168528,"Primarily in person, some courses online",http://adrian.edu/campus-life/health-counseling-center/public-health,26091,1781,Primarily In Person,347,2128
East Central Community College,175643,"Primarily in person, some courses online",https://www.eccc.edu/coronavirus,28101,1785,Primarily In Person,259,2044
Chatham University,211556,"Primarily in person, some courses online",https://chatham.edu/student-experience/health-wellness/coronavirus-updates.html,42003,1790,Primarily In Person,472,2262
McKendree University,147013,"Primarily in person, some courses online",https://www.mckendree.edu/news/coronavirus-2020.php,17163,1791,Primarily In Person,306,2097
Big Sandy Community and Technical College,157553,"Primarily in person, some courses online",https://bigsandy.kctcs.edu/covid-19/,21071,1792,Primarily In Person,251,2043
King University,220516,"Primarily in person, some courses online",https://www.king.edu/news/coronavirus/,47163,1792,Primarily In Person,274,2066
SOWELA Technical Community College,160579,"Primarily in person, some courses online",https://www.sowela.edu/student-life/student-services/health-center/coronavirus/,22019,1796,Primarily In Person,234,2030
University of Charleston,237312,"Primarily in person, some courses online",https://www.ucwv.edu/coronavirus-information/,54039,1809,Primarily In Person,369,2178
Seton Hill University,215947,"Primarily in person, some courses online",https://www.setonhill.edu/student-life/counseling-disability-health-services/coronavirus-updates/,42129,1812,Primarily In Person,351,2163
Louisiana State University-Alexandria,159382,"Primarily in person, some courses online",http://www.lsua.edu/coronavirus,22079,1819,Primarily In Person,250,2069
Bates College,160977,"Primarily in person, some courses online",https://www.bates.edu/about/covid-19-information/,23001,1832,Primarily In Person,756,2588
Eastern University,212133,"Primarily in person, some courses online",https://www.eastern.edu/covid19,42045,1834,Primarily In Person,427,2261
Limestone College,218238,"Primarily in person, some courses online",https://my.limestone.edu/main-campus/student-health/health-education/corona,45021,1836,Primarily In Person,261,2097
Carson-Newman University,219806,"Primarily in person, some courses online",https://www.cnsummit.net/covid19-fall-return,47089,1839,Primarily In Person,383,2222
Viterbo University,240107,"Primarily in person, some courses online",https://www.viterbo.edu/moving-forward-viterbo/covid-19-coronavirus-information,55063,1844,Primarily In Person,375,2219
Bridgewater College,231581,"Primarily in person, some courses online",https://www.bridgewater.edu/life-at-bridgewater/services-for-students/health-counseling/public-health-advisory-information-on-covid-19/,51165,1850,Primarily In Person,355,2205
Gardner-Webb University,198561,"Primarily in person, some courses online",https://gardner-webb.edu/offices-and-departments/departments/university-police/emergency-information/health-advisories/coronavirus/index,37045,1854,Primarily In Person,513,2367
Tiffin University,206048,"Primarily in person, some courses online",https://www.tiffin.edu/offices/campus-safety-security/coronavirus,39147,1860,Primarily In Person,349,2209
Central Community College,180902,"Primarily in person, some courses online",https://www.cccneb.edu/coronavirus-information,31079,1864,Primarily In Person,608,2472
The University of the Arts,215105,"Primarily in person, some courses online",https://www.uarts.edu/about/information-about-coronavirus/general-faq,42101,1865,Primarily In Person,444,2309
University of Pikeville,157535,"Primarily in person, some courses online",https://www.upike.edu/coronavirus/,21195,1869,Primarily In Person,340,2209
Lake Superior College,173461,"Primarily in person, some courses online",https://www.lsc.edu/coronavirus/,27137,1876,Primarily In Person,257,2133
St Bonaventure University,195164,"Primarily in person, some courses online",https://www.sbu.edu/coronavirus-information,36009,1885,Primarily In Person,505,2390
Oklahoma Christian University,207324,"Primarily in person, some courses online",https://www.oc.edu/about/coronavirus-covid-19/oc-responds-to-covid-19,40109,1886,Primarily In Person,348,2234
North Park University,147679,"Primarily in person, some courses online",https://www.northpark.edu/fall-2020/,17031,1893,Primarily In Person,450,2343
Delaware Valley University,211981,"Primarily in person, some courses online",https://delval.edu/life-at-delval/health-services/covid-19-information,42017,1916,Primarily In Person,411,2327
Georgia Southwestern State University,139764,"Primarily in person, some courses online",https://www.gsw.edu/resources/facultyandstaff/ur/alert/coronavirus,13261,1931,Primarily In Person,327,2258
Berry College,139144,"Primarily in person, some courses online",https://www.berry.edu/student-life/life-on-campus/fall-opening/,13115,1934,Primarily In Person,538,2472
Eckerd College,133492,"Primarily in person, some courses online",https://www.eckerd.edu/coronavirus/,12103,1940,Primarily In Person,340,2280
Emmanuel College,165671,"Primarily in person, some courses online",https://ec.edu/community-health/,25025,1942,Primarily In Person,345,2287
Alvernia University,210775,"Primarily in person, some courses online",https://www.alvernia.edu/current-students/health-wellness-center/health-alerts,42011,1946,Primarily In Person,400,2346
Medaille College,192925,"Primarily in person, some courses online",https://www.medaille.edu/covid-19-coronavirus-campus-update-march-12-2020,36029,1953,Primarily In Person,383,2336
Misericordia University,214069,"Primarily in person, some courses online",https://www.misericordia.edu/coronavirus,42079,1957,Primarily In Person,482,2439
Kettering University,169983,"Primarily in person, some courses online",https://www.kettering.edu/covid-19,26049,1964,Primarily In Person,389,2353
Benedictine College,154712,"Primarily in person, some courses online",https://www.benedictine.edu/coronavirus/index,20005,1974,Primarily In Person,327,2301
East Georgia State College,139621,"Primarily in person, some courses online",http://www.ega.edu/covid19,13107,1999,Primarily In Person,227,2226
Colby College,161086,"Primarily in person, some courses online",https://covid19.colby.edu/,23011,2000,Primarily In Person,769,2769
Saint Anselm College,183239,"Primarily in person, some courses online",https://www.anselm.edu/covid-19-response,33011,2007,Primarily In Person,608,2615
Central State University,201690,"Primarily in person, some courses online",https://www.centralstate.edu/PR/index2.php?num=106&fbclid=IwAR0Ysc7xy1EhHO-SDhZGSPAJcsJvGMqZVQ0H_Xs4IvDedEx67-NBU4QZFJ0,39057,2029,Primarily In Person,375,2404
Bismarck State College,200022,"Primarily in person, some courses online",https://bismarckstate.edu/news/Return-to-Campus/,38015,2040,Primarily In Person,373,2413
Concordia College at Moorhead,173300,"Primarily in person, some courses online",https://www.concordiacollege.edu/directories/offices-departments-directory/emergency/info-covid-19/,27027,2041,Primarily In Person,600,2641
St. Thomas University,137476,"Primarily in person, some courses online",https://www.stu.edu/coronavirus/,12086,2042,Primarily In Person,478,2520
Curry College,165529,"Primarily in person, some courses online",https://www.curry.edu/student-life/health-and-wellness/health-services/coronavirus-(covid-19)-information,25021,2045,Primarily In Person,431,2476
Southern Nazarene University,206862,"Primarily in person, some courses online",https://snu.edu/fall2020/,40109,2046,Primarily In Person,326,2372
Genesee Community College,191339,"Primarily in person, some courses online",https://www.genesee.edu/home/emergency-notices/coronavirus-covid-19-gcc-response-information/,36037,2047,Primarily In Person,386,2433
Hutchinson Community College,155195,"Primarily in person, some courses online",https://www.hutchcc.edu/covid-19,20155,2055,Primarily In Person,493,2548
Walsh University,206437,"Primarily in person, some courses online",https://www.walsh.edu/coronavirus.html,39151,2055,Primarily In Person,413,2468
Trinity Valley Community College,225308,"Primarily in person, some courses online",https://www.tvcc.edu/Covid-19/category.aspx?z=1375,48213,2058,Primarily In Person,419,2477
SUNY College of Agriculture and Technology at Cobleskill,196033,"Primarily in person, some courses online",https://www.cobleskill.edu/fall2020plan/index.aspx,36095,2061,Primarily In Person,394,2455
Weatherford College,229799,"Primarily in person, some courses online",https://www.wc.edu/COVID-19,48367,2066,Primarily In Person,404,2470
Gateway Community College,130396,"Primarily in person, some courses online",https://www.gatewayct.edu/President-Ojakian,09009,2069,Primarily In Person,391,2460
Southwest Baptist University,179326,"Primarily in person, some courses online",https://www.sbuniv.edu/coronavirus/,29167,2074,Primarily In Person,423,2497
Lenoir-Rhyne University,198835,"Primarily in person, some courses online",https://www.lr.edu/coronavirus,37035,2077,Primarily In Person,380,2457
Minot State University,200253,"Primarily in person, some courses online",https://www.minotstateu.edu/health/covid-19/,38101,2093,Primarily In Person,453,2546
Northeast Community College,181491,"Primarily in person, some courses online",https://northeast.edu/Coronavirus/,31119,2094,Primarily In Person,443,2537
Williams College,168342,"Primarily in person, some courses online",https://www.williams.edu/coronavirus/,25003,2096,Primarily In Person,1151,3247
Hamline University,173665,"Primarily in person, some courses online",https://www.hamline.edu/covid-19/,27123,2097,Primarily In Person,491,2588
University of Northwestern-St Paul,174491,"Primarily in person, some courses online",https://www.unwsp.edu/news/coronavirus,27123,2109,Primarily In Person,501,2610
Trinity College,130590,"Primarily in person, some courses online",https://www.trincoll.edu/advisories/covid-19-updates/,09003,2116,Primarily In Person,679,2795
Bard College,189088,"Primarily in person, some courses online",https://www.bard.edu/covid19/,36027,2121,Primarily In Person,860,2981
Kilgore College,226019,"Primarily in person, some courses online",https://www.kilgore.edu/current-students/coronavirus-covid-19-information,48183,2136,Primarily In Person,420,2556
King's College,213321,"Primarily in person, some courses online",https://www.kings.edu/mykings/covid-19-information,42079,2136,Primarily In Person,474,2610
DePauw University,150400,"Primarily in person, some courses online",https://www.depauw.edu/coronavirus/,18133,2139,Primarily In Person,612,2751
Western State Colorado University,128391,"Primarily in person, some courses online",https://www.western.edu/resources-and-updates-related-covid-19-coronavirus,08051,2145,Primarily In Person,351,2496
North Greenville University,218441,"Primarily in person, some courses online",https://www.ngu.edu/covid-19.php,45045,2150,Primarily In Person,434,2584
Lincoln University,213598,"Primarily in person, some courses online",https://www.lincolnu.edu/web/lincoln/health-safety-information,42029,2155,Primarily In Person,362,2517
Franciscan University of Steubenville,205957,"Primarily in person, some courses online",https://franciscan.edu/returning-to-campus-in-fall-2020/,39081,2184,Primarily In Person,384,2568
Trine University,152567,"Primarily in person, some courses online",https://www.trine.edu/trine-strong/index.aspx,18151,2184,Primarily In Person,420,2604
Faulkner University,101189,"Primarily in person, some courses online",https://www.faulkner.edu/coronavirus-update/,01101,2185,Primarily In Person,346,2531
Salve Regina University,217536,"Primarily in person, some courses online",https://salve.edu/back-to-salve,44005,2185,Primarily In Person,456,2641
Union College,196866,"Primarily in person, some courses online",https://ucollege.edu/covid-19,36093,2195,Primarily In Person,840,3035
University of Montevallo,101709,"Primarily in person, some courses online",https://www.montevallo.edu/about-um/marcomm/coronavirus-information/,01117,2202,Primarily In Person,529,2731
Lewis-Clark State College,142328,"Primarily in person, some courses online",https://www.lcsc.edu/communications/coronavirus,16069,2209,Primarily In Person,464,2673
Moberly Area Community College,178448,"Primarily in person, some courses online",https://www.macc.edu/covid19,29175,2211,Primarily In Person,346,2557
Washington and Lee University,234207,"Primarily in person, some courses online",https://my.wlu.edu/covid-19-resources,51678,2219,Primarily In Person,940,3159
Colorado Christian University,126669,"Primarily in person, some courses online",https://www.ccu.edu/coronavirus/,08059,2256,Primarily In Person,648,2904
Delta State University,175616,"Primarily in person, some courses online",http://www.deltastate.edu/academic-affairs/delta-state-universitys-response-to-coronavirus/,28011,2260,Primarily In Person,534,2794
Lindsey Wilson College,157216,"Primarily in person, some courses online",https://kwc.edu/academics/academic-bulletin/,21001,2264,Primarily In Person,389,2653
Rogers State University,207661,"Primarily in person, some courses online",https://www.rsu.edu/resources/coronavirus/,40131,2267,Primarily In Person,342,2609
Walla Walla Community College,236887,"Primarily in person, some courses online",https://www.wwcc.edu/coronavirus/,53071,2270,Primarily In Person,370,2640
Central Oregon Community College,208318,"Primarily in person, some courses online",https://www.cocc.edu/news/coronavirus.aspx,41017,2302,Primarily In Person,398,2700
Andrews University,168740,"Primarily in person, some courses online",https://www.andrews.edu/agenda/56284/,26021,2307,Primarily In Person,755,3062
Susquehanna University,216278,"Primarily in person, some courses online",https://www.susqu.edu/coronavirus-update,42109,2311,Primarily In Person,487,2798
Oklahoma City University,207458,"Primarily in person, some courses online",https://www.okcu.edu/main/coronavirus/,40109,2339,Primarily In Person,574,2913
Fort Valley State University,139719,"Primarily in person, some courses online",https://www.fvsu.edu/coronavirus-updates/,13225,2364,Primarily In Person,607,2971
Eastern Iowa Community College District,153311,"Primarily in person, some courses online",https://www.eicc.edu/about-eicc/coronavirus/index.aspx,19163,2404,Primarily In Person,520,2924
Upper Iowa University,154493,"Primarily in person, some courses online",https://www.uiu.edu/coronavirus/index.html,19065,2409,Primarily In Person,491,2900
Northwest Florida State College,136233,"Primarily in person, some courses online",https://nwfsc.edu/coronavirus/,12091,2424,Primarily In Person,434,2858
Montana State University Billings,180179,"Primarily in person, some courses online",http://www.msubillings.edu/covid19central/,30111,2440,Primarily In Person,489,2929
Minnesota State Community and Technical College,173559,"Primarily in person, some courses online",https://www.minnesota.edu/coronavirus,27111,2445,Primarily In Person,317,2762
Ohio Christian University,201964,"Primarily in person, some courses online",https://www.ohiochristian.edu/emergency/coronavirus,39129,2448,Primarily In Person,338,2786
Whitworth University,237066,"Primarily in person, some courses online",https://www.whitworth.edu/cms/administration/health-and-counseling-services/health-center/coronavirus-information/,53063,2451,Primarily In Person,552,3003
Union University,221971,"Primarily in person, some courses online",https://www.uu.edu/studentlife/office/20200306-covid-19.cfm,47113,2462,Primarily In Person,507,2969
Kapiolani Community College,141796,"Primarily in person, some courses online",https://www.kapiolani.hawaii.edu/covid-19/,15003,2492,Primarily In Person,443,2935
Lynn University,132657,"Primarily in person, some courses online",https://www.lynn.edu/roadmap,12099,2516,Primarily In Person,651,3167
Augustana College,143084,"Primarily in person, some courses online",https://www.augustana.edu/augustana-strong,17161,2534,Primarily In Person,597,3131
Middlesex Community College,166887,"Primarily in person, some courses online",https://mxcc.edu/coronavirus/,25017,2566,Primarily In Person,577,3143
University of Mary,200217,"Primarily in person, some courses online",https://www.umary.edu/student-life/campus-safety-security/health.php,38015,2572,Primarily In Person,470,3042
Spring Arbor University,172334,"Primarily in person, some courses online",https://www.arbor.edu/about/offices-and-schools/holton-health-and-wellness-services/coronavirus-updates-and-resources/,26075,2585,Primarily In Person,360,2945
Louisiana State University-Shreveport,159416,"Primarily in person, some courses online",https://www.lsus.edu/coronavirus-updates,22017,2602,Primarily In Person,370,2972
Saint Ambrose University,154235,"Primarily in person, some courses online",https://www.sau.edu/covid19,19163,2604,Primarily In Person,498,3102
Shepherd University,237792,"Primarily in person, some courses online",https://www.shepherd.edu/getramready,54037,2623,Primarily In Person,455,3078
Canisius College,189705,"Primarily in person, some courses online",https://www.canisius.edu/canisius-returns-campus,36029,2640,Primarily In Person,576,3216
Le Moyne College,192323,"Primarily in person, some courses online",https://www.lemoyne.edu/COVID-19,36067,2674,Primarily In Person,547,3221
Northeast Mississippi Community College,176169,"Primarily in person, some courses online",https://nemcc.instructure.com/courses/413294,28117,2679,Primarily In Person,331,3010
Iowa Central Community College,153524,"Primarily in person, some courses online",https://www.iowacentral.edu/covid-19/index.asp,19187,2682,Primarily In Person,472,3154
Carthage College,238476,"Primarily in person, some courses online",https://www.carthage.edu/carthage-covid-19/,55059,2696,Primarily In Person,466,3162
Jacksonville University,134945,"Primarily in person, some courses online",https://www.ju.edu/readytoreturn/index.php,12031,2702,Primarily In Person,666,3368
North Central College,147660,"Primarily in person, some courses online",https://covid.northcentralcollege.edu/?_ga=2.249471364.2046119322.1594249247-1766501760.1594249247,17043,2727,Primarily In Person,527,3254
University of Maryland Eastern Shore,163338,"Primarily in person, some courses online",https://www.umes.edu/uploadedFiles/_WEBSITES/RTC/Content/UMES%20Return%20to%20Campus%202020.%206.29.20.pdf,24039,2730,Primarily In Person,700,3430
Hawaii Pacific University,141644,"Primarily in person, some courses online",https://www.hpu.edu/security/covid/covid-19.html#covid-news,15003,2736,Primarily In Person,508,3244
Benedictine University,145619,"Primarily in person, some courses online",http://www.ben.edu/coronavirus/index.cfm,17043,2737,Primarily In Person,519,3256
College of Western Idaho,455114,"Primarily in person, some courses online",http://cwi.edu/info/coronavirus-disease-covid-19-information-and-resources,16027,2746,Primarily In Person,752,3498
Indiana Wesleyan University-Marion,151801,"Primarily in person, some courses online",https://www.indwes.edu/covid19,18053,2748,Primarily In Person,795,3543
Anderson University,217633,"Primarily in person, some courses online",https://anderson.edu/coronavirus/,45007,2775,Primarily In Person,528,3303
Bethel University,173160,"Primarily in person, some courses online",https://www.bethelu.edu/about/coronavirus-covid-19-updates,27123,2801,Primarily In Person,735,3536
Our Lady of the Lake University,227331,"Primarily in person, some courses online",https://www.ollusa.edu/health-safety/emergency-preparedness/coronavirus-information/index.html?_ga=2.206053907.1666145261.1588610392-762393146.1585003595,48029,2818,Primarily In Person,497,3315
Citadel Military College of South Carolina,217864,"Primarily in person, some courses online",https://www.citadel.edu/root/registrar-covid-19,45019,2830,Primarily In Person,691,3521
Chattahoochee Technical College,140331,"Primarily in person, some courses online",https://www.chattahoocheetech.edu/coronavirus/,13067,2832,Primarily In Person,602,3434
Palm Beach Atlantic University,136330,"Primarily in person, some courses online",https://www.pba.edu/campus-life/health-wellness/safety/covid-19/index.html,12099,2839,Primarily In Person,533,3372
Ohio Northern University,204635,"Primarily in person, some courses online",https://www.onu.edu/covid-19,39065,2846,Primarily In Person,536,3382
Marian University,151786,"Primarily in person, some courses online",https://www.marian.edu/_temp/coronavirus,18097,2849,Primarily In Person,565,3414
Cameron University,206914,"Primarily in person, some courses online",https://www.cameron.edu/covid-19,40031,2853,Primarily In Person,444,3297
Saint Xavier University,148627,"Primarily in person, some courses online",https://www.sxu.edu/coronavirus.asp,17031,2858,Primarily In Person,476,3334
Georgia Highlands College,139700,"Primarily in person, some courses online",https://sites.highlands.edu/marketing-and-communications/coronavirus-covid%E2%80%9119-information-and-resources/,13115,2882,Primarily In Person,405,3287
Fort Lewis College,127185,"Primarily in person, some courses online",https://www.fortlewis.edu/life-at-flc/health-safety/coronavirus-covid-19/coronavirus-covid-19-home,08067,2896,Primarily In Person,531,3427
Springfield College,167899,"Primarily in person, some courses online",https://springfield.edu/covid,25013,2911,Primarily In Person,690,3601
Culinary Institute of America,190503,"Primarily in person, some courses online",https://www.ciachef.edu/coronavirus-updates/,36027,2990,Primarily In Person,693,3683
Carroll University,238458,"Primarily in person, some courses online",https://www.carrollu.edu/student-services/health/coronavirus#updates,55133,2999,Primarily In Person,506,3505
George Fox University,208822,"Primarily in person, some courses online",https://www.georgefox.edu/covid19/index.html,41071,3003,Primarily In Person,643,3646
St Olaf College,174844,"Primarily in person, some courses online",https://wp.stolaf.edu/covid-19/,27131,3023,Primarily In Person,656,3679
Hope College,170301,"Primarily in person, some courses online",https://hope.edu/coronavirus/,26139,3032,Primarily In Person,739,3771
Francis Marion University,218061,"Primarily in person, some courses online",https://www.fmarion.edu/reopening2020/,45041,3053,Primarily In Person,546,3599
Xavier University of Louisiana,160904,"Primarily in person, some courses online",https://www.xula.edu/covid-19-information,22071,3080,Primarily In Person,741,3821
Molloy College,193292,"Primarily in person, some courses online",https://www.molloy.edu/molloy-life/student-health-and-wellness/coronavirus-updates/coronavirus-information,36059,3095,Primarily In Person,767,3862
Siena College,195474,"Primarily in person, some courses online",https://www.siena.edu/life-as-a-saint/marching-forward/,36001,3096,Primarily In Person,690,3786
Navarro College,227146,"Primarily in person, some courses online",https://www.navarrocollege.edu/covid-19/,48349,3127,Primarily In Person,430,3557
Western New England University,168254,"Primarily in person, some courses online",https://www1.wne.edu/coronavirus/index.cfm,25013,3129,Primarily In Person,717,3846
Texas A&M University-San Antonio,459949,"Primarily in person, some courses online",https://www.tamusa.edu/coronavirus/,48029,3137,Primarily In Person,533,3670
Saint John Fisher College,195720,"Primarily in person, some courses online",https://www.sjfc.edu/update/?utm_source=Campus+Reopen+Task+Force+Updates&utm_campaign=2ce529116b-EMAIL_CAMPAIGN_REOPEN_FY_T_G_FAM_2020_07_07&utm_medium=email&utm_term=0_d993b8e1e9-2ce529116b-,36055,3161,Primarily In Person,683,3844
Dalton State College,139463,"Primarily in person, some courses online",https://www.daltonstate.edu/campus_life/coronavirus-update.cms,13313,3190,Primarily In Person,360,3550
Trevecca Nazarene University,221892,"Primarily in person, some courses online",https://www.trevecca.edu/offices-services/coronavirus-covid-19,47037,3233,Primarily In Person,382,3615
Olivet Nazarene University,147828,"Primarily in person, some courses online",https://www.olivet.edu/update,17091,3234,Primarily In Person,610,3844
Baldwin Wallace University,201195,"Primarily in person, some courses online",https://www.bw.edu/advisory/fall-2020/,39035,3263,Primarily In Person,738,4001
Horry-Georgetown Technical College,218140,"Primarily in person, some courses online",https://www.hgtc.edu/current_students/covid-19/index.html,45051,3304,Primarily In Person,420,3724
Norwich University,230995,"Primarily in person, some courses online",https://www.norwich.edu/news/psa,50023,3340,Primarily In Person,677,4017
Wingate University,199962,"Primarily in person, some courses online",https://www.wingate.edu/return-to-campus,37179,3361,Primarily In Person,573,3934
Endicott College,165699,"Primarily in person, some courses online",https://www.endicott.edu/news-events/coronavirus-update,25009,3389,Primarily In Person,676,4065
University of Bridgeport,128744,"Primarily in person, some courses online",https://www.bridgeport.edu/notifications/information/2020-06-02/university-response-covid-19,09001,3404,Primarily In Person,570,3974
School of the Art Institute of Chicago,143048,"Primarily in person, some courses online",https://www.saic.edu/covid19/communications,17031,3432,Primarily In Person,787,4219
University of Richmond,233374,"Primarily in person, some courses online",https://www.richmond.edu/coronavirus/index.html,51760,3449,Primarily In Person,1700,5149
SUNY College of Technology at Alfred,196006,"Primarily in person, some courses online",https://www.alfredstate.edu/covid-19,36003,3456,Primarily In Person,595,4051
Calvin College,169080,"Primarily in person, some courses online",https://calvin.edu/coronavirus/,26081,3476,Primarily In Person,707,4183
Valparaiso University,152600,"Primarily in person, some courses online",https://www.valpo.edu/looking-forward/,18127,3481,Primarily In Person,772,4253
Concordia University-Saint Paul,173328,"Primarily in person, some courses online",https://www.csp.edu/coronavirus/,27123,3487,Primarily In Person,340,3827
University of Mary Hardin-Baylor,226471,"Primarily in person, some courses online",https://go.umhb.edu/coronavirus/covid-19,48027,3509,Primarily In Person,552,4061
Butler Community College,154800,"Primarily in person, some courses online",https://www.butlercc.edu/coronavirus,20015,3518,Primarily In Person,567,4085
Colorado State University-Pueblo,128106,"Primarily in person, some courses online",https://www.csupueblo.edu/coronavirus/index.html,08101,3526,Primarily In Person,580,4106
Cape Fear Community College,198154,"Primarily in person, some courses online",https://cfcc.edu/coronavirus/,37129,3552,Primarily In Person,910,4462
Bethel University,219718,"Primarily in person, some courses online",https://www.bethel.edu/covid-19/,47017,3555,Primarily In Person,506,4061
Southern Oregon University,210146,"Primarily in person, some courses online",https://sou.edu/campus/notifications/,41029,3613,Primarily In Person,576,4189
Cedarville University,201654,"Primarily in person, some courses online",https://www.cedarville.edu/caring-well-staying-well,39057,3619,Primarily In Person,620,4239
Bucknell University,211291,"Primarily in person, some courses online",https://www.bucknell.edu/life-bucknell/health-wellness-safety/coronavirus-covid-19-updates,42119,3621,Primarily In Person,1357,4978
Bryant University,217165,"Primarily in person, some courses online",https://covid.bryant.edu/,44007,3622,Primarily In Person,743,4365
Regent University,231651,"Primarily in person, some courses online",https://www.regent.edu/news-events/regent-university-statement-on-coronavirus/,51810,3628,Primarily In Person,624,4252
Lane Community College,209038,"Primarily in person, some courses online",https://www.lanecc.edu/covid19,41039,3638,Primarily In Person,652,4290
Missouri Western State University,178387,"Primarily in person, some courses online",https://www.missouriwestern.edu/covid-19/,29021,3673,Primarily In Person,529,4202
Fitchburg State University,165820,"Primarily in person, some courses online",https://www.fitchburgstate.edu/offices-services-directory/health-services/coronavirus-information/,25027,3695,Primarily In Person,634,4329
Emporia State University,155025,"Primarily in person, some courses online",https://www.emporia.edu/covid-19-information/esu-fall-2020-return-campus/return-campus-student-information/,20111,3715,Primarily In Person,722,4437
Concordia University-Wisconsin,238616,"Primarily in person, some courses online",https://www.cuw.edu/landingpages/covid19/index.html,55089,3722,Primarily In Person,753,4475
Pacific University,209612,"Primarily in person, some courses online",https://www.pacificu.edu/coronavirus,41067,3725,Primarily In Person,806,4531
Abilene Christian University,222178,"Primarily in person, some courses online",https://www.acu.edu/coronavirus.html,48441,3730,Primarily In Person,856,4586
Drake University,153269,"Primarily in person, some courses online",https://www.drake.edu/coronavirus/,19153,3760,Primarily In Person,1045,4805
Lincoln Memorial University,220631,"Primarily in person, some courses online",https://www.lmunet.edu/covid.php,47025,3824,Primarily In Person,995,4819
Longwood University,232566,"Primarily in person, some courses online",http://www.longwood.edu/covid19/,51147,3929,Primarily In Person,817,4746
Clayton  State University,139311,"Primarily in person, some courses online",https://www.clayton.edu/coronavirus/,13063,4013,Primarily In Person,706,4719
Webster University,179894,"Primarily in person, some courses online",http://www.webster.edu/covid19/,29189,4074,Primarily In Person,1075,5149
Southwestern Oklahoma State University,207865,"Primarily in person, some courses online",https://bulldog.swosu.edu/coronavirus/index.php,40039,4088,Primarily In Person,550,4638
Grambling State University,159009,"Primarily in person, some courses online",https://www.gram.edu/news/notification/,22061,4098,Primarily In Person,546,4644
CUNY Hostos Community College,190585,"Primarily in person, some courses online",http://www.hostos.cuny.edu/Administrative-Offices/Division-of-Administration-and-Finance/Environmental-Health-Safety/Health-Alerts,36005,4138,Primarily In Person,833,4971
Roger Williams University,217518,"Primarily in person, some courses online",https://www.rwu.edu/reopening-roger,44001,4144,Primarily In Person,927,5071
Missouri Southern State University,178341,"Primarily in person, some courses online",https://emergency.mssu.edu/,29097,4201,Primarily In Person,603,4804
Lipscomb University,219976,"Primarily in person, some courses online",https://www.lipscomb.edu/return-campus-plan,47037,4211,Primarily In Person,998,5209
Union County College,187198,"Primarily in person, some courses online",https://www.ucc.edu/blog/2020/03/09/coronavirus-preparations-at-union/,34039,4223,Primarily In Person,643,4866
Midlands Technical College,218353,"Primarily in person, some courses online",https://www.midlandstech.edu/student-information,45063,4239,Primarily In Person,752,4991
Northampton County Area Community College,214379,"Primarily in person, some courses online",https://www.northampton.edu/coronavirus.htm,42095,4255,Primarily In Person,1070,5325
Greenville Technical College,218113,"Primarily in person, some courses online",https://www.gvltec.edu/about_greenvilletech/administration_governance/covid-19-response/coronavirus.html,45045,4261,Primarily In Person,890,5151
Spokane Community College,236692,"Primarily in person, some courses online",https://scc.spokane.edu/News-Events/Coronavirus,53063,4262,Primarily In Person,766,5028
South Plains College,228158,"Primarily in person, some courses online",https://www.southplainscollege.edu/emergency/covid19-faq.php,48219,4280,Primarily In Person,627,4907
University of Arkansas-Fort Smith,108092,"Primarily in person, some courses online",https://campuslife.uafs.edu/services/health-center/covid19,05131,4304,Primarily In Person,562,4866
Guilford Technical Community College,198622,"Primarily in person, some courses online",https://www.gtcc.edu/coronavirus.php,37081,4316,Primarily In Person,860,5176
Eastern Connecticut State University,129215,"Primarily in person, some courses online",https://www.easternct.edu/reopening/index.html,09015,4331,Primarily In Person,722,5053
Worcester State University,168430,"Primarily in person, some courses online",https://www.worcester.edu/Public-Health-Information/,25027,4331,Primarily In Person,720,5051
Pennsylvania College of Technology,366252,"Primarily in person, some courses online",https://www.pct.edu/campus-life/college-health-services/coronavirus,42081,4378,Primarily In Person,1000,5378
Fairfield University,129242,"Primarily in person, some courses online",https://www.fairfield.edu/undergraduate/student-life-and-services/health-and-wellness/health-center/emergencies/coronavirus/,09001,4461,Primarily In Person,957,5418
Florida Institute of Technology,133881,"Primarily in person, some courses online",https://www.fit.edu/coronavirus/,12009,4519,Primarily In Person,1153,5672
Sinclair Community College,205470,"Primarily in person, some courses online",https://www.sinclair.edu/services/conduct-safety/public-safety/coronavirus/,39113,4547,Primarily In Person,1351,5898
Northwest Mississippi Community College,176178,"Primarily in person, some courses online",http://www.northwestms.edu/index.php/?page_id=33737,28137,4652,Primarily In Person,639,5291
Eastern Illinois University,144892,"Primarily in person, some courses online",http://www.eiu.edu/covid,17029,4767,Primarily In Person,1100,5867
Bowie State University,162007,"Primarily in person, some courses online",https://bowiestate.edu/campus-life/health-and-wellness/henry-wise-wellness-center/corona-virus-information/,24033,4884,Primarily In Person,758,5642
Middle Georgia State University,482158,"Primarily in person, some courses online",https://www.mga.edu/coronavirus/index.php,13021,4893,Primarily In Person,753,5646
Vincennes University,152637,"Primarily in person, some courses online",https://www.vinu.edu/coronavirus-updates,18083,4970,Primarily In Person,1044,6014
Community College of Baltimore County,434672,"Primarily in person, some courses online",https://www.ccbcmd.edu/About-CCBC/Policies-and-Procedures/Coronavirus/phased-return.aspx,24005,5081,Primarily In Person,1829,6910
Monmouth University,185572,"Primarily in person, some courses online",https://www.monmouth.edu/covid-19/,34025,5106,Primarily In Person,1153,6259
University of Hartford,129525,"Primarily in person, some courses online",https://www.hartford.edu/academics/academic-calendar/fall-opening.aspx,09003,5113,Primarily In Person,1173,6286
Columbus State University,139366,"Primarily in person, some courses online",https://www.columbusstate.edu/coronavirus/,13215,5152,Primarily In Person,955,6107
University of La Verne,117140,"Primarily in person, some courses online",https://laverne.edu/health/coronavirus/,06037,5202,Primarily In Person,837,6039
University of North Carolina at Pembroke,199281,"Primarily in person, some courses online",https://www.uncp.edu/about/update-coronavirus-covid-19,37155,5274,Primarily In Person,945,6219
Yeshiva University,197708,"Primarily in person, some courses online",https://www.yu.edu/fall2020,36061,5379,Primarily In Person,1221,6600
Texas A & M International University,226152,"Primarily in person, some courses online",https://www.tamiu.edu/coronavirus/student-faqs.shtml,48479,5382,Primarily In Person,701,6083
Xavier University,206622,"Primarily in person, some courses online",https://www.xavier.edu/return-to-campus/,39061,5392,Primarily In Person,1161,6553
Marist College,192819,"Primarily in person, some courses online",https://www.marist.edu/coronavirus-updates,36027,5440,Primarily In Person,1026,6466
Ozarks Technical Community College,177472,"Primarily in person, some courses online",https://www.otc.edu/covid/,29077,5509,Primarily In Person,969,6478
Georgia College & State University,139861,"Primarily in person, some courses online",https://www.gcsu.edu/coronavirus,13009,5721,Primarily In Person,995,6716
Colorado School of Mines,126775,"Primarily in person, some courses online",https://www.mines.edu/coronavirus/,08059,5801,Primarily In Person,1186,6987
University of New Haven,129941,"Primarily in person, some courses online",https://www.newhaven.edu/reopening/index.php,09009,5907,Primarily In Person,917,6824
McNeese State University,159717,"Primarily in person, some courses online",https://www.mcneese.edu/emergency/return-to-campus,22019,5930,Primarily In Person,693,6623
Texas A & M University-Kingsville,228705,"Primarily in person, some courses online",https://www.tamuk.edu/coronavirus/,48273,5980,Primarily In Person,938,6918
West Texas A & M University,229814,"Primarily in person, some courses online",https://www.wtamu.edu/about/information/covid-19/index.html,48381,6113,Primarily In Person,849,6962
Dixie State University,230171,"Primarily in person, some courses online",https://wellness.dixie.edu/coronavirus-information/,49053,6125,Primarily In Person,877,7002
University of South Dakota,219471,"Primarily in person, some courses online",https://www.usd.edu/covid19,46027,6252,Primarily In Person,1421,7673
Sacred Heart University,130253,"Primarily in person, some courses online",https://www.sacredheart.edu/offices--departments-directory/health-services/coronavirus/,09001,6325,Primarily In Person,1202,7527
Northern Michigan University,171456,"Primarily in person, some courses online",https://www.nmu.edu/covid/,26103,6338,Primarily In Person,970,7308
Michigan Technological University,171128,"Primarily in person, some courses online",https://www.mtu.edu/flex/,26061,6438,Primarily In Person,1450,7888
Lamar University,226091,"Primarily in person, some courses online",https://www.lamar.edu/coronavirus/index.html,48245,6457,Primarily In Person,1397,7854
Northwestern State University of Louisiana,160038,"Primarily in person, some courses online",https://www.nsula.edu/covid-19/,22069,6489,Primarily In Person,880,7369
Metropolitan Community College-Kansas City,177995,"Primarily in person, some courses online",https://www.mcckc.edu/coronavirus,29095,6550,Primarily In Person,1488,8038
Arkansas Tech University,106467,"Primarily in person, some courses online",https://www.atu.edu/pandemicrecovery/,05115,6583,Primarily In Person,984,7567
Elon University,198516,"Primarily in person, some courses online",https://www.elon.edu/u/ready-and-resilient,37001,6703,Primarily In Person,1460,8163
Saginaw Valley State University,172051,"Primarily in person, some courses online",https://www.svsu.edu/coronavirus/,26145,6743,Primarily In Person,856,7599
Murray State University,157401,"Primarily in person, some courses online",https://www.murraystate.edu/healthupdate/,21035,6770,Primarily In Person,1251,8021
Western Illinois University,149772,"Primarily in person, some courses online",http://www.wiu.edu/vpas/risk_management_and_emergency_preparedness/coronavirus/index.php,17109,6778,Primarily In Person,1293,8071
Cuyahoga Community College District,202356,"Primarily in person, some courses online",https://www.tri-c.edu/administrative-departments/business-continuity/covid-19/index.html,39035,6980,Primarily In Person,2254,9234
Colorado Mesa University,127556,"Primarily in person, some courses online",https://www.coloradomesa.edu/covid-19/index.html,08077,7108,Primarily In Person,793,7901
Missouri University of Science and Technology,178411,"Primarily in person, some courses online",https://coronavirus.mst.edu/,29161,7117,Primarily In Person,1277,8394
Creighton University,181002,"Primarily in person, some courses online",https://www.creighton.edu/about/covid-19,31055,7119,Primarily In Person,2090,9209
Texas A & M University-Commerce,224554,"Primarily in person, some courses online",https://www.tamuc.edu/facultyStaffServices/humanResources/covid-19-resources/default.aspx,48231,7179,Primarily In Person,1020,8199
Idaho State University,142276,"Primarily in person, some courses online",https://www.isu.edu/roaringback/,16005,7445,Primarily In Person,1796,9241
Arkansas State University-Main Campus,106458,"Primarily in person, some courses online",https://www.astate.edu/safety/novel-coronavirus/,05031,7456,Primarily In Person,1751,9207
William Paterson University of New Jersey,187444,"Primarily in person, some courses online",https://www.wpunj.edu/covid19/index.html,34031,7598,Primarily In Person,1402,9000
Southeast Missouri State University,179557,"Primarily in person, some courses online",https://semo.edu/sealerts/covid19/,29031,7677,Primarily In Person,1118,8795
Valdosta State University,141264,"Primarily in person, some courses online",https://www.valdosta.edu/health-advisory/coronavirus.php,13185,7726,Primarily In Person,1182,8908
Villanova University,216597,"Primarily in person, some courses online",https://www1.villanova.edu/university/coronavirus/updates.html,42045,7876,Primarily In Person,2568,10444
University of Central Missouri,176965,"Primarily in person, some courses online",https://www.ucmo.edu/news/media-resources/corona-virus-covid-19/,29101,8009,Primarily In Person,1239,9248
Radford University,233277,"Primarily in person, some courses online",,51750,8090,Primarily In Person,1413,9503
Texas A & M University-Corpus Christi,224147,"Primarily in person, some courses online",https://www.tamucc.edu/campus-announcements/coronavirus.html,48355,8184,Primarily In Person,1343,9527
Tennessee Technological University,221847,"Primarily in person, some courses online",https://www.tntech.edu/return/index.php,47141,8290,Primarily In Person,1259,9549
Prairie View A & M University,227526,"Primarily in person, some courses online",https://www.pvamu.edu/coronavirus/,48473,8427,Primarily In Person,1205,9632
University of Idaho,142285,"Primarily in person, some courses online",https://www.uidaho.edu/vandal-health-clinic/coronavirus,16057,8436,Primarily In Person,2509,10945
The University of Tampa,137847,"Primarily in person, some courses online",https://www.ut.edu/about-ut/university-services/office-of-public-information/fall-2020-opening,12057,8470,Primarily In Person,999,9469
Long Island University,192448,"Primarily in person, some courses online",https://liu.edu/coronavirus,36059,8497,Primarily In Person,1455,9952
Quinnipiac University,130226,"Primarily in person, some courses online",https://www.qu.edu/student-resources/health-campus-safety/coronavirus.html,09009,8624,Primarily In Person,1564,10188
Tarleton State University,228529,"Primarily in person, some courses online",https://www.tarleton.edu/coronavirus/index.html,48143,8735,Primarily In Person,1151,9886
Louisiana Tech University,159647,"Primarily in person, some courses online",https://www.latech.edu/coronavirus/,22061,8877,Primarily In Person,1143,10020
Ferris State University,169910,"Primarily in person, some courses online",https://www.ferris.edu/HTMLS/news/coronavirus/message-to-students-june26-2020.htm,26107,8916,Primarily In Person,1352,10268
Texas Woman's University,229179,"Primarily in person, some courses online",https://twu.edu/coronavirus/,48121,9001,Primarily In Person,1494,10495
University of Northern Iowa,154095,"Primarily in person, some courses online",https://forwardtogether.uni.edu/,19013,9264,Primarily In Person,1641,10905
Hofstra University,191649,"Primarily in person, some courses online",https://news.hofstra.edu/category/hofstra-campus/covid-19/,36059,9331,Primarily In Person,2057,11388
University of West Georgia,141334,"Primarily in person, some courses online",https://www.westga.edu/student-services/health/coronavirus-info.php,13045,9339,Primarily In Person,1669,11008
Indiana State University,151324,"Primarily in person, some courses online",https://www.indstate.edu/covid-19,18167,9793,Primarily In Person,1656,11449
The University of Tennessee-Chattanooga,221740,"Primarily in person, some courses online",https://blog.utc.edu/coronavirus/,47065,9802,Primarily In Person,1596,11398
University of Wisconsin-Eau Claire,240268,"Primarily in person, some courses online",https://www.uwec.edu/coronavirus-updates/,55035,9906,Primarily In Person,1153,11059
North Carolina A & T State University,199102,"Primarily in person, some courses online",https://www.ncat.edu/coronavirus/index.php,37081,10458,Primarily In Person,1767,12225
Tulane University of Louisiana,160755,"Primarily in person, some courses online",https://tulane.edu/covid-19,22071,10509,Primarily In Person,4958,15467
Saint Louis University,179159,"Primarily in person, some courses online",https://www.slu.edu/health-advisory/index.php,29510,10520,Primarily In Person,4702,15222
Central Washington University,234827,"Primarily in person, some courses online",https://www.cwu.edu/emergency/covid-19-updates,53037,10568,Primarily In Person,1465,12033
Collin County Community College District,247834,"Primarily in person, some courses online",http://www.collincollegenews.com/2020/07/09/coronavirus-covid-19-faqs/,48085,10662,Primarily In Person,1726,12388
University of Central Oklahoma,206941,"Primarily in person, some courses online",https://www.uco.edu/coronavirus/,40109,10687,Primarily In Person,1579,12266
University of Nebraska at Omaha,181394,"Primarily in person, some courses online",https://www.unomaha.edu/fall-forward/index.php,31055,10862,Primarily In Person,1655,12517
Eastern Kentucky University,156620,"Primarily in person, some courses online",https://staywell.eku.edu/novel-coronavirus-2019-ncov#_ga=2.40028002.1529513397.1594338079-1853238443.1594338079,21151,11166,Primarily In Person,1982,13148
Florida Gulf Coast University,433660,"Primarily in person, some courses online",https://www.fgcu.edu/coronaupdate/,12071,11651,Primarily In Person,1575,13226
University of Notre Dame,152080,"Primarily in person, some courses online",https://here.nd.edu/,18141,12323,Primarily In Person,5961,18284
Keiser University-Ft Lauderdale,135081,"Primarily in person, some courses online",https://www.keiseruniversity.edu/covid/,12011,12605,Primarily In Person,3043,15648
Montana State University,180461,"Primarily in person, some courses online",https://www.montana.edu/health/coronavirus/index.html,30031,13085,Primarily In Person,2838,15923
Boston College,164924,"Primarily in person, some courses online",https://www.bc.edu/content/bc-web/sites/reopening-boston-college.html,25017,13165,Primarily In Person,3755,16920
University of Louisiana at Lafayette,160658,"Primarily in person, some courses online",https://louisiana.edu/covid19?utm_source=website&utm_medium=banner&utm_campaign=covid-updates,22055,13484,Primarily In Person,2027,15511
Boise State University,142115,"Primarily in person, some courses online",https://www.boisestate.edu/coronavirus-response/,16001,13895,Primarily In Person,2821,16716
Rochester Institute of Technology,195003,"Primarily in person, some courses online",https://www.rit.edu/news/accelerated-fall-calendar-path-forward,36055,14867,Primarily In Person,3730,18597
Rowan University,184782,"Primarily in person, some courses online",https://www.rowan.edu/returntorowan/,34015,15661,Primarily In Person,3258,18919
University of Toledo,206084,"Primarily in person, some courses online",https://www.utoledo.edu/offices/provost/covid-19-response-information.html,39095,15859,Primarily In Person,3284,19143
University of Miami,135726,"Primarily in person, some courses online",https://coronavirus.miami.edu/fall-2020-plan/index.html,12086,15904,Primarily In Person,12139,28043
Ball State University,150136,"Primarily in person, some courses online",https://www.bsu.edu/about/administrativeoffices/emergency-preparedness/pandemicfluprep/coronavirus,18035,15926,Primarily In Person,3357,19283
Western Michigan University,172699,"Primarily in person, some courses online",https://wmich.edu/president/fall-2020-schedule-set,26077,16030,Primarily In Person,2815,18845
Old Dominion University,232982,"Primarily in person, some courses online",https://www.odu.edu/emergency/news/2020/2/novel_coronavirus_co#.XwU1GC2z1QI,51710,16605,Primarily In Person,2806,19411
Kansas State University,155399,"Primarily in person, some courses online",https://www.k-state.edu/covid-19/,20161,18838,Primarily In Person,4631,23469
Oklahoma State University-Main Campus,207388,"Primarily in person, some courses online",https://go.okstate.edu/coronavirus/index.html,40119,19387,Primarily In Person,5179,24566
Ivy Tech Community College,150987,"Primarily in person, some courses online",https://www.ivytech.edu/coronavirus.html,18097,20678,Primarily In Person,4471,25149
Georgia Southern University,139931,"Primarily in person, some courses online",https://www.georgiasouthern.edu/covid-19-information/,13031,20843,Primarily In Person,3151,23994
University of Oklahoma-Norman Campus,207500,"Primarily in person, some courses online",https://www.ou.edu/coronavirus,40027,22059,Primarily In Person,5341,27400
University of Nebraska-Lincoln,181464,"Primarily in person, some courses online",https://covid19.unl.edu/2019-novel-coronavirus-covid-19,31109,22191,Primarily In Person,6239,28430
University of Kansas,155317,"Primarily in person, some courses online",https://coronavirus.ku.edu/,20045,23027,Primarily In Person,8362,31389
Virginia Commonwealth University,234030,"Primarily in person, some courses online",https://covid-19.vcu.edu,51760,25301,Primarily In Person,6802,32103
Colorado State University-Fort Collins,126818,"Primarily in person, some courses online",https://covidrecovery.colostate.edu/,08069,25601,Primarily In Person,7041,32642
University of Iowa,153658,"Primarily in person, some courses online",https://coronavirus.uiowa.edu/,19103,26432,Primarily In Person,9818,36250
Brigham Young University-Provo,230038,"Primarily in person, some courses online",https://www.byu.edu/coronavirus/,49049,30162,Primarily In Person,4565,34727
Texas State University,228459,"Primarily in person, some courses online",https://www.txstate.edu/coronavirus/road-map.html,48209,30584,Primarily In Person,4006,34590
Iowa State University,153603,"Primarily in person, some courses online",https://web.iastate.edu/safety/updates/covid19,19169,31213,Primarily In Person,6331,37544
University of South Carolina-Columbia,218663,"Primarily in person, some courses online",https://sc.edu/safety/coronavirus/,45079,31270,Primarily In Person,6555,37825
Texas Tech University,229115,"Primarily in person, some courses online",https://www.depts.ttu.edu/communications/emergency/coronavirus/,48303,31495,Primarily In Person,5029,36524
Virginia Polytechnic Institute and State University,233921,"Primarily in person, some courses online",https://vt.edu/ready/home.html,51121,31972,Primarily In Person,8331,40303
The University of Alabama,100751,"Primarily in person, some courses online",https://healthinfo.ua.edu/,01125,33038,Primarily In Person,6402,39440
University of Georgia,139959,"Primarily in person, some courses online",https://www.uga.edu/coronavirus/info.php,13059,34930,Primarily In Person,11270,46200
Purdue University-Main Campus,243780,"Primarily in person, some courses online",https://protect.purdue.edu/timeline/,18157,38395,Primarily In Person,10592,48987
Liberty University,232557,"Primarily in person, some courses online",https://www.liberty.edu/students/health-wellness/coronavirus/,51680,41809,Primarily In Person,5367,47176
University of Central Florida,132903,"Primarily in person, some courses online",https://www.ucf.edu/coronavirus/returning-to-ucf/,12095,46575,Primarily In Person,5884,52459
Texas A & M University-College Station,228723,"Primarily in person, some courses online",https://www.tamu.edu/coronavirus/index.html,48041,59220,Primarily In Person,10709,69929
The Workforce Institute's City College,214023,"Primarily online, some courses in person",https://www.aspiracitycollege.edu/blog/covid-19-information/,42101,8,Primarily Online,5,13
California Jazz Conservatory,486488,"Primarily online, some courses in person",https://cjc.edu/cjc-covid-19-resources/,06001,31,Primarily Online,25,56
Nebraska Indian Community College,181419,"Primarily online, some courses in person",http://www.thenicc.edu/index.php/en/nicc-news-updates-2/125-featured-news/788-covid-19-resources,31173,34,Primarily Online,41,75
Keweenaw Bay Ojibwa Community College,461315,"Primarily online, some courses in person",https://www.kbocc.edu/covid-response/,26013,38,Primarily Online,32,70
Saginaw Chippewa Tribal College,441070,"Primarily online, some courses in person",https://www.sagchip.edu/updates,26073,53,Primarily Online,27,80
Saint Louis Christian College,179256,"Primarily online, some courses in person",https://stlchristian.edu/wp-content/uploads/2020/03/SLCC-Updated-COVID-19-Response-03.19.20.pdf,29189,62,Primarily Online,30,92
Carolinas College of Health Sciences,433174,"Primarily online, some courses in person",https://online.carolinascollege.edu/course/view.php?id=123#section-1,37119,65,Primarily Online,61,126
Laboure College,165264,"Primarily online, some courses in person",https://www.laboure.edu/coronavirus,25021,65,Primarily Online,137,202
Purdue University Global-Cedar Falls,260910,"Primarily online, some courses in person",https://www.purdueglobal.edu/covid-19-contact-tracing-course/,19013,69,Primarily Online,0,69
College of Menominee Nation,413617,"Primarily online, some courses in person",http://www.menominee.edu/news2.aspx,55078,91,Primarily Online,97,188
Lac Courte Oreilles Ojibwa Community College,260372,"Primarily online, some courses in person",https://www.lco.edu/single-post/2020/05/21/Update-from-LCOOC-Regarding-COVID-19-Pandemic,55113,104,Primarily Online,63,167
Aultman College of Nursing and Health Sciences,201177,"Primarily online, some courses in person",https://www.aultmancollege.edu/coronavirus,39151,106,Primarily Online,63,169
Saint John's Seminary,167677,"Primarily online, some courses in person",https://www.sjs.edu/news,25025,114,Primarily Online,28,142
Leech Lake Tribal College,413626,"Primarily online, some courses in person",https://www.lltc.edu/,27021,121,Primarily Online,47,168
Good Samaritan College of Nursing and Health Science,202912,"Primarily online, some courses in person",https://www.cdc.gov/coronavirus/2019-ncov/cases-updates/index.html,39061,136,Primarily Online,57,193
Tohono O'Odham Community College,442781,"Primarily online, some courses in person",https://tocc.edu/covid-19/,04019,141,Primarily Online,106,247
Reid State Technical College,101994,"Primarily online, some courses in person",http://www.rstc.edu/?PN=Pages&SubP=Level1Page&L=0&DivisionID=23841&PageID=39393,01035,148,Primarily Online,61,209
New Mexico State University-Grants,188021,"Primarily online, some courses in person",https://nmsu.edu/coronavirus/#communications,35006,164,Primarily Online,51,215
Casa Loma College-Van Nuys,111638,"Primarily online, some courses in person",https://casalomacollege.edu/corona-virus/,06037,175,Primarily Online,36,211
Cabarrus College of Health Sciences,198109,"Primarily online, some courses in person",https://atriumhealth.org/education/cabarrus-college-of-health-sciences/coronavirus-update,37025,179,Primarily Online,67,246
Bladen Community College,198011,"Primarily online, some courses in person",https://www.bladencc.edu/public-health-notifications/,37017,187,Primarily Online,138,325
Johnson University Florida,132879,"Primarily online, some courses in person",https://johnsonu.edu/?s=covid,12097,192,Primarily Online,53,245
Pamlico Community College,199263,"Primarily online, some courses in person",https://www.pamlicocc.edu/home-news.php#covid190331,37137,205,Primarily Online,74,279
Washington County Community College,161581,"Primarily online, some courses in person",https://www.wccc.me.edu/covid-19/,23029,213,Primarily Online,71,284
Herzing University-Minneapolis,174154,"Primarily online, some courses in person",https://www.herzing.edu/coronavirus,27053,241,Primarily Online,57,298
Pennsylvania College of Art and Design,215053,"Primarily online, some courses in person",https://pcad.edu/alerts/covid-19-response-status/,42071,242,Primarily Online,66,308
Pennsylvania Institute of Technology,214582,"Primarily online, some courses in person",https://www.pit.edu/coronavirus/,42045,247,Primarily Online,69,316
Jewish Theological Seminary of America,192040,"Primarily online, some courses in person",http://www.jtsa.edu/jts-coronavirus-information,36061,248,Primarily Online,195,443
White Mountains Community College,183105,"Primarily online, some courses in person",https://www.wmcc.edu/wmcc-coronavirus-covid-19-information/,33007,253,Primarily Online,94,347
Alaska Pacific University,102669,"Primarily online, some courses in person",https://www.alaskapacific.edu/campus-reopening-plan/,02020,258,Primarily Online,127,385
Remington College-Nashville Campus,445249,"Primarily online, some courses in person",https://www.remingtoncollege.edu/covid-19/,47037,265,Primarily Online,44,309
Humphreys University-Stockton and Modesto Campuses,115773,"Primarily online, some courses in person",https://www.humphreys.edu/quick-links/coronavirus-updates-information/,06077,266,Primarily Online,66,332
American Academy of Dramatic Arts-New York,188678,"Primarily online, some courses in person",https://www.aada.edu/search/fall?,36061,270,Primarily Online,48,318
West Shore Community College,172671,"Primarily online, some courses in person",https://www.westshore.edu/campus-life/campus-safety/coronavirus/,26105,271,Primarily Online,101,372
Nicolet Area Technical College,239442,"Primarily online, some courses in person",https://www.nicoletcollege.edu/about/covid-19-updates,55085,279,Primarily Online,195,474
Miles Community College,180373,"Primarily online, some courses in person",https://www.milescc.edu/health/default.aspx,30017,283,Primarily Online,90,373
Ancilla College,150048,"Primarily online, some courses in person",https://www.ancilla.edu/coronavirus/,18099,305,Primarily Online,63,368
J. F. Drake State Community and Technical College,101462,"Primarily online, some courses in person",https://www.drakestate.edu/current-students,01089,312,Primarily Online,73,385
New Hampshire Institute of Art,430810,"Primarily online, some courses in person",https://www.nec.edu/fall-plans/,33011,315,Primarily Online,0,315
Institute of American Indian and Alaska Native Culture and Arts Development,187745,"Primarily online, some courses in person",https://iaia.edu/about/covid-19/,35049,317,Primarily Online,117,434
Oconee Fall Line Technical College,420431,"Primarily online, some courses in person",https://www.oftc.edu/covid-19-faqs-2/#students,13303,318,Primarily Online,209,527
Mayland Community College,198914,"Primarily online, some courses in person",https://www.mayland.edu/covid19-updates/,37011,322,Primarily Online,158,480
Lakes Region Community College,183123,"Primarily online, some courses in person",https://www.lrcc.edu/coronavirus/,33001,327,Primarily Online,90,417
Northwest Technical College,173115,"Primarily online, some courses in person",https://www.bemidjistate.edu/coronavirus/,27007,331,Primarily Online,59,390
Roxbury Community College,167631,"Primarily online, some courses in person",https://www.rcc.mass.edu/about-us/news/1184-coronavirus-information-for-the-rcc-community,25025,332,Primarily Online,290,622
Methodist College,147129,"Primarily online, some courses in person",https://www.methodistcol.edu/coronavirus.aspx,17143,341,Primarily Online,108,449
University of Maine at Machias,161244,"Primarily online, some courses in person",https://machias.edu/return/,23029,345,Primarily Online,82,427
Montserrat College of Art,166911,"Primarily online, some courses in person",https://www.montserrat.edu/covid19/,25009,351,Primarily Online,72,423
Arkansas State University Mid-South,107318,"Primarily online, some courses in person",https://www.asumidsouth.edu/coronavirus/,05035,356,Primarily Online,162,518
Johnson College,213233,"Primarily online, some courses in person",https://johnson.edu/2020/06/coronavirus-covid-19-update/,42069,361,Primarily Online,108,469
Wilson Community College,199953,"Primarily online, some courses in person",https://www.wilsoncc.edu/covid-19/,37195,369,Primarily Online,190,559
Florida Keys Community College,133960,"Primarily online, some courses in person",https://www.fkcc.edu/covid-19/covid-19-updates/,12087,371,Primarily Online,122,493
Moore College of Art and Design,214148,"Primarily online, some courses in person",https://moore.edu/student-life/health/coronavirus-advisory,42101,373,Primarily Online,120,493
New Mexico State University-Carlsbad,188003,"Primarily online, some courses in person",https://nmsu.edu/coronavirus/#communications,35015,374,Primarily Online,104,478
Clarkson College,180832,"Primarily online, some courses in person",https://www.clarksoncollege.edu/coronavirus/index,31055,375,Primarily Online,143,518
Northwestern Connecticut Community College,130040,"Primarily online, some courses in person",https://www.nwcc.edu/coronavirus-info/,09005,379,Primarily Online,108,487
Altierus Career College-Bissonnet,445461,"Primarily online, some courses in person",https://www.altierus.edu/studentcommunications,48201,382,Primarily Online,42,424
Paul D Camp Community College,233037,"Primarily online, some courses in person",https://www.pdc.edu/servicesandresources/resources-and-services-for-students/department-of-public-safety/2019-novel-coronavirus-updates-information/,51620,383,Primarily Online,104,487
New Mexico State University-Alamogordo,187994,"Primarily online, some courses in person",https://nmsu.edu/coronavirus/#communications,35035,384,Primarily Online,111,495
Northern Maine Community College,161484,"Primarily online, some courses in person",https://www.nmcc.edu/coronavirus-updates/,23003,404,Primarily Online,92,496
Bryan College of Health Sciences,180878,"Primarily online, some courses in person",https://www.bryanhealthcollege.edu/bcohs/student-life/health-wellness/responseteam/,31109,408,Primarily Online,86,494
Altierus Career College-Norcross,443748,"Primarily online, some courses in person",https://www.altierus.edu/studentcommunications,13135,411,Primarily Online,47,458
Goodwin College,129154,"Primarily online, some courses in person",https://www.goodwin.edu/covid-19/response,09003,416,Primarily Online,408,824
Pine Manor College,167455,"Primarily online, some courses in person",http://pmc.publishpath.com/Default.aspx?shortcut=COVID-19-Coronavirus-info,25021,416,Primarily Online,118,534
Academy for Nursing and Health Occupations,412173,"Primarily online, some courses in person",https://www.anho.edu/PREVENTATIVE-AIRBORNE-INFECTION-SPREAD,12099,417,Primarily Online,33,450
York County Community College,420440,"Primarily online, some courses in person",https://www.yccc.edu/covid19/,23031,421,Primarily Online,89,510
Herzing University-Atlanta,140340,"Primarily online, some courses in person",https://www.herzing.edu/coronavirus,13121,423,Primarily Online,47,470
Herzing University-Winter Park,386472,"Primarily online, some courses in person",https://www.herzing.edu/coronavirus,12117,426,Primarily Online,50,476
Kent State University at Ashtabula,203447,"Primarily online, some courses in person",https://www.kent.edu/ashtabula-covid-19-updates,39007,426,Primarily Online,116,542
Pine Technical & Community College,174570,"Primarily online, some courses in person",https://www.pine.edu/coronavirus/,27115,427,Primarily Online,84,511
Sampson Community College,199625,"Primarily online, some courses in person",https://www.sampsoncc.edu/covid-19updates/,37163,430,Primarily Online,191,621
Mercy College of Ohio,203960,"Primarily online, some courses in person",https://mercycollege.edu/covid19,39095,434,Primarily Online,185,619
Vermilion Community College,175157,"Primarily online, some courses in person",https://www.vcc.edu/covid-19/,27137,439,Primarily Online,54,493
East Arkansas Community College,106883,"Primarily online, some courses in person",https://www.eacc.edu/view-home-page?id=53,05123,440,Primarily Online,165,605
Kirtland Community College,170587,"Primarily online, some courses in person",https://www.kirtland.edu/coronavirus,26039,457,Primarily Online,100,557
Cox College,176770,"Primarily online, some courses in person",https://coxcollege.edu/blog/cox-college-covid-19-campus-advisory/,29077,471,Primarily Online,102,573
Kent State University at Salem,203492,"Primarily online, some courses in person",https://www.kent.edu/coronavirus,39029,472,Primarily Online,91,563
College of Eastern Idaho,142179,"Primarily online, some courses in person",http://www.cei.edu/covid-19-information/,16019,479,Primarily Online,288,767
Salem Community College,186469,"Primarily online, some courses in person",http://www.salemcc.edu/virusinfo,34033,482,Primarily Online,105,587
Helena College University of Montana,180276,"Primarily online, some courses in person",http://www.helenacollege.edu/campus_safety/health_advisories.aspx,30049,488,Primarily Online,116,604
Baptist Memorial College of Health Sciences,219639,"Primarily online, some courses in person",https://www.bchs.edu/coronavirus,47157,494,Primarily Online,152,646
Nashua Community College,183141,"Primarily online, some courses in person",https://www.ccsnh.edu/covid-19/,33011,497,Primarily Online,145,642
Southern California Institute of Architecture,123952,"Primarily online, some courses in person",https://www.sciarc.edu/institution/covid-19-updates-and-resources,06037,499,Primarily Online,114,613
University of Connecticut-Avery Point,436827,"Primarily online, some courses in person",https://reopen.uconn.edu/,09011,502,Primarily Online,87,589
Capitol Technology University,162061,"Primarily online, some courses in person",https://www.captechu.edu/news-events/safely-securing-your-future,24033,509,Primarily Online,86,595
Charles R Drew University of Medicine and Science,111966,"Primarily online, some courses in person",https://www.cdrewu.edu/updates-covid-19,06037,521,Primarily Online,381,902
Gogebic Community College,169992,"Primarily online, some courses in person",https://www.gogebic.edu/covid-19.html,26053,523,Primarily Online,99,622
Rockingham Community College,199485,"Primarily online, some courses in person",https://www.rockinghamcc.edu/about/coronavirus,37157,524,Primarily Online,219,743
Centenary College of Louisiana,158477,"Primarily online, some courses in person",https://www.centenary.edu/directories/offices-services-directory/public-safety/covid-19-information/,22017,549,Primarily Online,167,716
Berkshire Community College,164775,"Primarily online, some courses in person",https://www.berkshirecc.edu/about-bcc/covid19resources.php,25003,553,Primarily Online,212,765
Brunswick Community College,198084,"Primarily online, some courses in person",https://www.brunswickcc.edu/coronavirus/,37019,553,Primarily Online,296,849
Feather River Community College District,114433,"Primarily online, some courses in person",https://www.frc.edu/updates,06063,554,Primarily Online,133,687
South Piedmont Community College,197850,"Primarily online, some courses in person",https://spcc.edu/coronavirus-update/,37007,568,Primarily Online,254,822
Greenfield Community College,165981,"Primarily online, some courses in person",https://www.gcc.mass.edu/safety/healthalerts/,25011,573,Primarily Online,213,786
Kennebec Valley Community College,161192,"Primarily online, some courses in person",https://www.kvcc.me.edu/coronavirus/,23025,573,Primarily Online,122,695
Carlos Albizu University-Miami,132842,"Primarily online, some courses in person",https://albizuinfo.com/,12086,574,Primarily Online,107,681
Hibbing Community College,173735,"Primarily online, some courses in person",https://hibbing.edu/news/covid-19-faqs,27137,576,Primarily Online,99,675
Chesapeake College,162168,"Primarily online, some courses in person",https://www.chesapeake.edu/coronavirus,24035,579,Primarily Online,290,869
University of Maine at Fort Kent,161235,"Primarily online, some courses in person",https://umfk-umm.libguides.com/return2020,23003,581,Primarily Online,130,711
Copper Mountain Community College,395362,"Primarily online, some courses in person",https://www.cmccd.edu/covid-19-student-resources/,06071,585,Primarily Online,128,713
Spoon River College,148991,"Primarily online, some courses in person",http://www.src.edu/Pages/Re-opening-Plan.aspx,17057,586,Primarily Online,127,713
Trocaire College,196653,"Primarily online, some courses in person",https://trocaire.edu/trocaire-college-fall-2020-semester-update/,36029,589,Primarily Online,176,765
Kent State University at Trumbull,203474,"Primarily online, some courses in person",https://www.kent.edu/trumbull/coronavirus-updates-trumbull,39155,591,Primarily Online,113,704
University of New Hampshire at Manchester,183071,"Primarily online, some courses in person",https://manchester.unh.edu/coronavirus-covid-19-updates,33011,592,Primarily Online,117,709
Southeastern Illinois College,148937,"Primarily online, some courses in person",http://www.sic.edu/alerts/coronavirus-communication,17165,595,Primarily Online,113,708
Great Bay Community College,183150,"Primarily online, some courses in person",https://www.greatbay.edu/covid-19-updates/,33015,598,Primarily Online,155,753
Clinton Community College,190053,"Primarily online, some courses in person",https://www.clinton.edu/degrees-and-programs/college-catalog.aspx,36019,601,Primarily Online,113,714
Mesabi Range College,173993,"Primarily online, some courses in person",https://www.mesabirange.edu/about/covid-19-information,27137,601,Primarily Online,79,680
Arkansas State University-Mountain Home,420538,"Primarily online, some courses in person",https://asumh.edu/pages/main/535/safety,05005,605,Primarily Online,129,734
Clarendon College,223922,"Primarily online, some courses in person",https://www.clarendoncollege.edu/Blog/Fall-Semester-2020/20181,48129,611,Primarily Online,109,720
Technical College of the Lowcountry,217712,"Primarily online, some courses in person",https://www.tcl.edu/campus-life/campus-security/emergency/,45013,615,Primarily Online,189,804
Marion Technical College,203881,"Primarily online, some courses in person",https://www.mtc.edu/covid-19/,39101,617,Primarily Online,157,774
Northland Pioneer College,105349,"Primarily online, some courses in person",https://www.npc.edu/covid-19,04017,621,Primarily Online,284,905
Central Wyoming College,240514,"Primarily online, some courses in person",https://www.cwc.edu/coronavirus/,56013,622,Primarily Online,245,867
Columbia-Greene Community College,190169,"Primarily online, some courses in person",https://www.sunycgcc.edu/news-and-events/covid-19//,36021,622,Primarily Online,159,781
Blue Ridge Community College,198039,"Primarily online, some courses in person",https://www.blueridge.edu/2020/06/25/coronavirus-covid-19/,37089,625,Primarily Online,273,898
Lake Tahoe Community College,117195,"Primarily online, some courses in person",http://www.ltcc.edu/campusresources/health-and-safety/coronavirus.php,06017,631,Primarily Online,168,799
Great Falls College Montana State University,180249,"Primarily online, some courses in person",http://www.gfcmsu.edu/covid/,30013,635,Primarily Online,134,769
West Virginia Northern Community College,238014,"Primarily online, some courses in person",https://www.wvncc.edu/coronavirus-update,54069,638,Primarily Online,151,789
Colby Community College,154934,"Primarily online, some courses in person",https://www.colbycc.edu/news-information/2019-20/covid-19-updates.html,20193,641,Primarily Online,119,760
Lakeshore Technical College,239008,"Primarily online, some courses in person",https://gotoltc.edu/coronavirus,55071,644,Primarily Online,287,931
Cleveland Institute of Art,202046,"Primarily online, some courses in person",https://www.cia.edu/about-us/safety-security/smart-return-to-school,39035,649,Primarily Online,167,816
Edgecombe Community College,198491,"Primarily online, some courses in person",https://www.edgecombe.edu/coronavirus-response/#top,37065,650,Primarily Online,219,869
University of Holy Cross,160065,"Primarily online, some courses in person",http://uhcno.edu/news/UHCcoronavirusupdates.html,22071,650,Primarily Online,161,811
Southern California University of Health Sciences,117672,"Primarily online, some courses in person",https://www.scuhs.edu/coronavirus-covid-19-information/,06037,659,Primarily Online,167,826
Alpena Community College,168607,"Primarily online, some courses in person",https://discover.alpenacc.edu/COVID-19/index.php,26007,670,Primarily Online,133,803
Windward Community College,141990,"Primarily online, some courses in person",https://windward.hawaii.edu/campus-life/safety-security/campus-emergency-preparedness-and-evacuation-procedures/coronavirus/,15003,677,Primarily Online,179,856
North Central Missouri College,179715,"Primarily online, some courses in person",https://www.ncmissouri.edu/studentlife/novel-coronavirus/,29079,681,Primarily Online,139,820
University of Arkansas Community College-Batesville,106999,"Primarily online, some courses in person",https://uaccb.edu/news/home/Covid+19+Updates,05063,681,Primarily Online,156,837
Southwestern Community College,154396,"Primarily online, some courses in person",https://www.southwesterncc.edu/news/updated-62620-1-pm-college-update-regarding-face-coverings,19175,683,Primarily Online,180,863
University of Arkansas Community College-Hope,107725,"Primarily online, some courses in person",https://www.uaht.edu/coronavirus-information/,05057,685,Primarily Online,150,835
Shawnee Community College,148821,"Primarily online, some courses in person",https://shawneecc.edu/statements-concerning-covid-19,17153,686,Primarily Online,121,807
Columbia College,112561,"Primarily online, some courses in person",https://www.gocolumbia.edu/about/coronavirus%20updates.php,06109,699,Primarily Online,169,868
Zane State College,204255,"Primarily online, some courses in person",https://www.zanestate.edu/info/,39119,699,Primarily Online,132,831
New River Community and Technical College,447582,"Primarily online, some courses in person",https://www.newriver.edu/coronavirus/,54081,700,Primarily Online,133,833
Mid-State Technical College,239220,"Primarily online, some courses in person",https://www.mstc.edu/covid-19-coronavirus,55141,701,Primarily Online,258,959
Minnesota State College Southeast,175263,"Primarily online, some courses in person",https://www.southeastmn.edu/current_student/page.aspx?id=12293#top,27169,701,Primarily Online,114,815
University of Alaska Southeast,102632,"Primarily online, some courses in person",https://sites.google.com/alaska.edu/coronavirus/uas?authuser=0,02110,705,Primarily Online,310,1015
Lincoln College,146676,"Primarily online, some courses in person",https://lincolncollege.edu/covid19/,17107,708,Primarily Online,221,929
Sierra Nevada College,182458,"Primarily online, some courses in person",https://www.sierranevada.edu/about/covid-19-information/,32031,709,Primarily Online,138,847
Aiken Technical College,217615,"Primarily online, some courses in person",https://www.atc.edu/Offices/Campus-Safety/COVID,45003,711,Primarily Online,177,888
Mount Carmel College of Nursing,204176,"Primarily online, some courses in person",https://www.mccn.edu/news/media-releases/1786-covid-19-resources,39049,712,Primarily Online,118,830
Sauk Valley Community College,148672,"Primarily online, some courses in person",https://www.svcc.edu/covid19/,17103,712,Primarily Online,157,869
Wright State University-Lake Campus,206613,"Primarily online, some courses in person",https://lake.wright.edu/about/news,39107,715,Primarily Online,96,811
Central Ohio Technical College,201672,"Primarily online, some courses in person",https://u.cotc.edu/covid19updates/,39089,735,Primarily Online,217,952
Rappahannock Community College,233310,"Primarily online, some courses in person",https://www.rappahannock.edu/health,51073,741,Primarily Online,179,920
Central Alabama Community College,100760,"Primarily online, some courses in person",https://www.cacc.edu/covid-19/,01123,742,Primarily Online,158,900
Thomas University,141167,"Primarily online, some courses in person",https://www.thomasu.edu/coronavirus-covid-19/,13275,751,Primarily Online,177,928
Stanly Community College,199740,"Primarily online, some courses in person",https://www.stanly.edu/COVID-19,37167,761,Primarily Online,296,1057
Community College of Vermont,230861,"Primarily online, some courses in person",https://ccv.edu/2020/03/19/information-on-coronavirus-covid-19/,50023,768,Primarily Online,311,1079
Southern State Community College,205966,"Primarily online, some courses in person",https://www.sscc.edu/coronavirus-covid-19-information.shtml,39071,768,Primarily Online,156,924
Clovis Community College,187639,"Primarily online, some courses in person",https://www.cloviscollege.edu/covid-19/index.html,35009,772,Primarily Online,202,974
Martin Methodist College,220701,"Primarily online, some courses in person",https://www.martinmethodist.edu/about/covid/19/alerts,47055,775,Primarily Online,115,890
William Jewell College,179955,"Primarily online, some courses in person",https://www.jewell.edu/coronavirus,29047,779,Primarily Online,214,993
Pennsylvania Highlands Community College,414911,"Primarily online, some courses in person",https://www.pennhighlands.edu/student-life/security-safety/coronavirus/,42021,781,Primarily Online,137,918
Cecil College,162104,"Primarily online, some courses in person",https://www.cecil.edu/coronavirus,24015,782,Primarily Online,305,1087
Sullivan County Community College,195988,"Primarily online, some courses in person",https://sunysullivan.edu/coronavirus-concerns/,36105,784,Primarily Online,146,930
The New England Conservatory of Music,167057,"Primarily online, some courses in person",https://necmusic.edu/resource-center,25025,785,Primarily Online,378,1163
North Country Community College,194028,"Primarily online, some courses in person",https://www.nccc.edu/fall-2020/,36031,790,Primarily Online,132,922
Missouri State University-West Plains,179344,"Primarily online, some courses in person",https://wp.missouristate.edu/Coronavirus/?rel=20200702T1722,29091,806,Primarily Online,176,982
Northwestern Health Sciences University,174507,"Primarily online, some courses in person",https://www.nwhealth.edu/covid-19/,27053,808,Primarily Online,207,1015
Mohave Community College,105206,"Primarily online, some courses in person",https://www.mohave.edu/about/safety/coronavirusupdates/,04015,809,Primarily Online,337,1146
Manchester Community College,183132,"Primarily online, some courses in person",https://www.manchestercc.edu/about/covid-19/,33011,817,Primarily Online,190,1007
Richland Community College,148292,"Primarily online, some courses in person",https://www.richland.edu/coronavirus/,17115,817,Primarily Online,215,1032
Community College of Beaver County,211079,"Primarily online, some courses in person",https://www.ccbc.edu/coronavirus,42007,820,Primarily Online,179,999
Monroe County Community College,171225,"Primarily online, some courses in person",https://www.monroeccc.edu/coronavirus/updates,26115,821,Primarily Online,224,1045
Southwestern Community College,199731,"Primarily online, some courses in person",https://www.swcciowa.edu/news/2020/covid-19-updates,37099,825,Primarily Online,337,1162
Heritage University,235422,"Primarily online, some courses in person",https://www.heritage.edu/coronavirus/,53077,826,Primarily Online,227,1053
Anoka Technical College,172954,"Primarily online, some courses in person",http://www.anokatech.edu/AboutATC/PublicSafety/Coronavirus-COVID-19-Response-Information,27003,828,Primarily Online,112,940
The Juilliard School,192110,"Primarily online, some courses in person",https://www.juilliard.edu/campus-life/covid-19-response,36061,829,Primarily Online,560,1389
Montana State University-Northern,180522,"Primarily online, some courses in person",https://www.msun.edu/covid-19/index.aspx,30041,830,Primarily Online,192,1022
AdventHealth University,133872,"Primarily online, some courses in person",https://www.ahu.edu/campus/policies-and-campus-safety/campus-safety/covid-19-info/,12095,831,Primarily Online,305,1136
New College of Florida,262129,"Primarily online, some courses in person",https://www.ncf.edu/covid-19/,12115,837,Primarily Online,324,1161
Briar Cliff University,152992,"Primarily online, some courses in person",https://www.briarcliff.edu/news/campus/a-message-on-the-corona-virus/,19193,838,Primarily Online,192,1030
H Councill Trenholm State Community College,102313,"Primarily online, some courses in person",https://www.trenholmstate.edu/college-information/coronavirus/,01101,840,Primarily Online,167,1007
Dine College,105297,"Primarily online, some courses in person",https://www.dinecollege.edu/coronavirus-faq/,04001,842,Primarily Online,295,1137
Flathead Valley Community College,180197,"Primarily online, some courses in person",https://www.fvcc.edu/coronavirus/,30029,848,Primarily Online,233,1081
Jefferson College of Health Sciences,231837,"Primarily online, some courses in person",https://www.radford.edu/content/radfordcore/home/coronavirus/overview.html,51770,849,Primarily Online,139,988
Blue Mountain Community College,208275,"Primarily online, some courses in person",https://www.bluecc.edu/community/resources/coronavirus,41059,853,Primarily Online,221,1074
Orangeburg Calhoun Technical College,218487,"Primarily online, some courses in person",https://www.octech.edu/covid19/student%20information/,45075,854,Primarily Online,205,1059
North Central State College,204422,"Primarily online, some courses in person",https://ncstatecollege.edu/coronavirus-faq/,39139,858,Primarily Online,214,1072
Wytheville Community College,234377,"Primarily online, some courses in person",https://www.wcc.vccs.edu/coronavirus,51197,861,Primarily Online,129,990
Edison State Community College,202648,"Primarily online, some courses in person",https://www.edisonohio.edu/COVID-19/,39109,865,Primarily Online,183,1048
St. Joseph's College-New York,195544,"Primarily online, some courses in person",https://www.sjcny.edu/em/corona,36047,865,Primarily Online,224,1089
Navajo Technical University,187596,"Primarily online, some courses in person",http://www.navajotech.edu/coronavirus,35031,868,Primarily Online,274,1142
City Colleges of Chicago-Olive-Harvey College,144175,"Primarily online, some courses in person",https://prepare.ccc.edu/,17031,874,Primarily Online,255,1129
Clarke University,153126,"Primarily online, some courses in person",https://www.clarke.edu/news/cu-coronavirus-2019-ncov-updates/,19061,878,Primarily Online,259,1137
Nunez Community College,158884,"Primarily online, some courses in person",https://www.nunez.edu/news/1676109/coronavirus-update-and-information,22087,879,Primarily Online,123,1002
Lurleen B Wallace Community College,101602,"Primarily online, some courses in person",https://www.lbwcc.edu/about-lbwcc/updates,01039,880,Primarily Online,148,1028
Virginia Highlands Community College,233903,"Primarily online, some courses in person",https://www.vhcc.edu/current-students/student-life/covid-19-updates,51191,882,Primarily Online,151,1033
Lakeland University,238980,"Primarily online, some courses in person",https://lakeland.edu/coronavirus,55117,894,Primarily Online,281,1175
Enterprise State Community College,101143,"Primarily online, some courses in person",https://www.escc.edu/coronavirus/,01031,899,Primarily Online,140,1039
Monmouth College,147341,"Primarily online, some courses in person",https://ou.monmouthcollege.edu/covid-19/communications.aspx,17187,905,Primarily Online,272,1177
Maharishi University of Management,153861,"Primarily online, some courses in person",https://www.miu.edu/admissions/coronavirus,19101,910,Primarily Online,378,1288
Metropolitan College of New York,190114,"Primarily online, some courses in person",https://www.mcny.edu/coronavirus/,36061,915,Primarily Online,156,1071
Edward Waters College,133526,"Primarily online, some courses in person",https://www.ewc.edu/covid-19-response-center/,12031,925,Primarily Online,205,1130
Vance-Granville Community College,199838,"Primarily online, some courses in person",https://www.vgcc.edu/category/emergency-news/,37181,927,Primarily Online,295,1222
The College of Idaho,142294,"Primarily online, some courses in person",https://www.collegeofidaho.edu/covid-19-updates,16027,928,Primarily Online,241,1169
North Central University,174437,"Primarily online, some courses in person",https://www.northcentral.edu/emergency-management/coronavirus-covid-19-information/,27053,930,Primarily Online,226,1156
Johnson & Wales University-Denver,439288,"Primarily online, some courses in person",https://covid.jwu.edu/?_ga=2.24807161.210140072.1594493986-886010914.1594493986,08031,934,Primarily Online,137,1071
Rockford University,148405,"Primarily online, some courses in person",https://www.rockford.edu/covid-19-updates/,17201,936,Primarily Online,231,1167
Great Basin College,182306,"Primarily online, some courses in person",https://www.gbcnv.edu/security/corona_virus.html,32007,939,Primarily Online,289,1228
Cerro Coso Community College,111896,"Primarily online, some courses in person",https://www.cerrocoso.edu/news/2020/0623-college-plans-fall-classes,06029,944,Primarily Online,192,1136
Oklahoma Panhandle State University,207351,"Primarily online, some courses in person",https://opsu.edu/coronavirus/reopening/,40139,946,Primarily Online,142,1088
Louisiana College,159568,"Primarily online, some courses in person",https://www.lacollege.edu/news/update-to-covid-19/,22079,962,Primarily Online,184,1146
Maine Maritime Academy,161299,"Primarily online, some courses in person",https://mainemaritime.edu/campus-safety/coronavirus/,23009,967,Primarily Online,268,1235
Surry Community College,199768,"Primarily online, some courses in person",https://surry.edu/coronavirus-covid-19-information,37171,973,Primarily Online,319,1292
Mitchell Community College,198987,"Primarily online, some courses in person",https://mitchellcc.edu/COVID-19,37097,974,Primarily Online,320,1294
California State University Maritime Academy,111188,"Primarily online, some courses in person",https://www.csum.edu/web/alert/covid-19/,06095,975,Primarily Online,308,1283
Transylvania University,157818,"Primarily online, some courses in person",https://www.transy.edu/healthy-at-transy/,21067,976,Primarily Online,283,1259
West Hills College-Coalinga,125462,"Primarily online, some courses in person",https://westhillscollege.com/covid19/,06019,981,Primarily Online,179,1160
Carroll Community College,405872,"Primarily online, some courses in person",https://www.carrollcc.edu/covid-19/,24013,982,Primarily Online,378,1360
North Arkansas College,107460,"Primarily online, some courses in person",http://www.northark.edu/about-us/public-health,05009,983,Primarily Online,226,1209
Kankakee Community College,146348,"Primarily online, some courses in person",https://coronavirus.kcc.edu/,17091,995,Primarily Online,291,1286
Canada College,111434,"Primarily online, some courses in person",https://covid-19.smccd.edu/,06081,999,Primarily Online,240,1239
College of the Albemarle,197814,"Primarily online, some courses in person",https://www.albemarle.edu/student-resources/campus-safety-security/updates/,37139,999,Primarily Online,274,1273
University of Hawaii Maui College,141839,"Primarily online, some courses in person",http://maui.hawaii.edu/health-center/coronavirus-update/,15009,999,Primarily Online,269,1268
Eastern Maine Community College,161138,"Primarily online, some courses in person",https://www.emcc.edu/timeline/covid-19-response-update/,23019,1003,Primarily Online,187,1190
South Georgia Technical College,141006,"Primarily online, some courses in person",http://www.southgatech.edu/sgtc-creates-informational-covid-19-video-for-students-faculty-staff/,13261,1008,Primarily Online,186,1194
Hagerstown Community College,162690,"Primarily online, some courses in person",https://www.hagerstowncc.edu/covid19,24043,1012,Primarily Online,361,1373
Cedar Crest College,211468,"Primarily online, some courses in person",https://www.cedarcrest.edu/healthservices/covid.shtm,42077,1018,Primarily Online,315,1333
Mendocino College,118684,"Primarily online, some courses in person",https://www.mendocino.edu/announcements,06045,1021,Primarily Online,243,1264
Madisonville Community College,157304,"Primarily online, some courses in person",https://www.lindsey.edu/academics/course-offerings/index.cfm#campus,21107,1023,Primarily Online,217,1240
Allen County Community College,154642,"Primarily online, some courses in person",https://www.allencc.edu/,20001,1030,Primarily Online,148,1178
University of Arkansas Community College-Morrilton,107585,"Primarily online, some courses in person",http://www.uaccm.edu/covid-19/index.html,05029,1032,Primarily Online,170,1202
Craven Community College,198367,"Primarily online, some courses in person",http://cravencc.edu/news/covid-19-updates/,37049,1038,Primarily Online,335,1373
Umpqua Community College,210270,"Primarily online, some courses in person",https://www.umpqua.edu/coronavirus?utm_source=sitewide-message&utm_medium=Website&utm_campaign=CoronavirusInformation,41019,1043,Primarily Online,268,1311
BridgeValley Community & Technical College,484932,"Primarily online, some courses in person",https://www.bridgevalley.edu/coronavirus,54039,1048,Primarily Online,194,1242
Kellogg Community College,170550,"Primarily online, some courses in person",https://www.kellogg.edu/about/coronavirus/,26025,1049,Primarily Online,393,1442
Santa Fe Community College,188137,"Primarily online, some courses in person",https://www.sfcc.edu/covid/,35049,1050,Primarily Online,467,1517
Victoria College,229540,"Primarily online, some courses in person",https://victoriacollege.edu/BusinessCommunity/covid-19-coronavirus,48469,1060,Primarily Online,416,1476
Hazard Community and Technical College,156790,"Primarily online, some courses in person",https://hazard.kctcs.edu/covid-19/,21193,1066,Primarily Online,235,1301
Mills College,118888,"Primarily online, some courses in person",https://www.mills.edu/covid-19/index.php,06001,1072,Primarily Online,366,1438
Southwest Virginia Community College,233648,"Primarily online, some courses in person",https://sw.edu/covid19/,51185,1076,Primarily Online,192,1268
Wilkes Community College,199926,"Primarily online, some courses in person",https://www.wilkescc.edu/COVID-19,37193,1095,Primarily Online,376,1471
Woodbury University,125897,"Primarily online, some courses in person",https://woodbury.edu/covid19/coronavirus-updates-resources/,06037,1101,Primarily Online,199,1300
Saint Joseph's College of Maine,161518,"Primarily online, some courses in person",https://www.sjcme.edu/highlights/,23005,1102,Primarily Online,338,1440
Minnesota West Community and Technical College,173638,"Primarily online, some courses in person",https://www.mnwest.edu/coronavirus,27173,1103,Primarily Online,171,1274
College of Our Lady of the Elms,167394,"Primarily online, some courses in person",https://www.elms.edu/coronavirus/,25013,1112,Primarily Online,233,1345
Piedmont Virginia Community College,233116,"Primarily online, some courses in person",https://www.pvcc.edu/coronavirus-covid-19,51003,1112,Primarily Online,285,1397
Blue Ridge Community and Technical College,446774,"Primarily online, some courses in person",https://www.blueridgectc.edu/about-blue-ridge/coronavirus-information/,54003,1113,Primarily Online,199,1312
College of the Mainland,226408,"Primarily online, some courses in person",https://www.com.edu/coronavirus,48167,1116,Primarily Online,434,1550
Reading Area Community College,215585,"Primarily online, some courses in person",https://www.remingtoncollege.edu/locations/dallas/?loc=2247,42011,1124,Primarily Online,298,1422
Wisconsin Indianhead Technical College,240198,"Primarily online, some courses in person",https://www.witc.edu/coronavirus,55129,1124,Primarily Online,533,1657
Trinity Washington University,131876,"Primarily online, some courses in person",https://discover.trinitydc.edu/alert/reopening-plan-timeline-and-class-formats/,11001,1127,Primarily Online,235,1362
Kentucky State University,157058,"Primarily online, some courses in person",https://kysu.edu/COVID19/,21073,1129,Primarily Online,518,1647
Mount Mary University,239390,"Primarily online, some courses in person",https://mtmary.edu/alert/coronavirus.html,55079,1137,Primarily Online,225,1362
Fulton-Montgomery Community College,191302,"Primarily online, some courses in person",https://www.fmcc.edu/2020/07/08/fall-2020-plan-unveiled/,36057,1139,Primarily Online,176,1315
Central Methodist University-College of Graduate and Extended Studies,445267,"Primarily online, some courses in person",https://www.centralmethodist.edu/student-life/services-and-resources/coronavirus-updates.php,29089,1145,Primarily Online,112,1257
GateWay Community College,105145,"Primarily online, some courses in person",https://www.gatewaycc.edu/news/2020/gateway-contributes-covid-19-cause,04013,1156,Primarily Online,438,1594
Central Maine Community College,161077,"Primarily online, some courses in person",https://www.cmcc.edu/coronavirus/,23001,1158,Primarily Online,171,1329
Northeast Alabama Community College,101897,"Primarily online, some courses in person",https://www.nwscc.edu/coronavirus-covid-19-information,01071,1159,Primarily Online,202,1361
Southeastern Community College,154378,"Primarily online, some courses in person",https://www.sccnc.edu/covid-19/,19057,1175,Primarily Online,267,1442
Western Nevada College,182564,"Primarily online, some courses in person",https://www.wnc.edu/covid-19/,32510,1182,Primarily Online,304,1486
La Roche University,213358,"Primarily online, some courses in person",https://www.laroche.edu/Student_Life/Counseling_and_Health_Services/Coronavirus_Updates/,42003,1187,Primarily Online,264,1451
Belhaven University,175421,"Primarily online, some courses in person",https://www.belhaven.edu/coronavirus/,28049,1188,Primarily Online,519,1707
Riverland Community College,173063,"Primarily online, some courses in person",https://www.riverland.edu/about-riverland/covid-19-information/,27099,1188,Primarily Online,195,1383
Blue Ridge Community College,231536,"Primarily online, some courses in person",https://www.brcc.edu/brcc/news/coronavirus.html,51015,1191,Primarily Online,237,1428
College for Creative Studies,169442,"Primarily online, some courses in person",https://www.collegeforcreativestudies.edu/fall-reopening-plan,26163,1195,Primarily Online,369,1564
Northcentral Technical College,239460,"Primarily online, some courses in person",https://www.ntc.edu/covid19,55073,1203,Primarily Online,417,1620
Dyersburg State Community College,220057,"Primarily online, some courses in person",https://www.dscc.edu/coronavirus,47045,1204,Primarily Online,233,1437
Morton College,147411,"Primarily online, some courses in person",https://www.morton.edu/covid-19-morton-college-response/,17031,1204,Primarily Online,271,1475
College of Alameda,108667,"Primarily online, some courses in person",https://alameda.peralta.edu/office-of-instruction/liberal-studies-and-language-arts-lsla/,06001,1205,Primarily Online,179,1384
Rend Lake College,148256,"Primarily online, some courses in person",https://www.rlc.edu/pressroom/14663-a-message-about-covid-19-coronavirus#fall-2020-semester-plan,17081,1213,Primarily Online,226,1439
Emory & Henry College,232025,"Primarily online, some courses in person",https://www.ehc.edu/covid19/,51191,1219,Primarily Online,285,1504
South Mountain Community College,105792,"Primarily online, some courses in person",https://www.maricopa.edu/coronavirus-covid-19,04013,1227,Primarily Online,296,1523
Catawba College,198215,"Primarily online, some courses in person",https://catawba.edu/news-events/coronavirus/community-updates/,37159,1229,Primarily Online,275,1504
Kaskaskia College,146366,"Primarily online, some courses in person",https://www.kaskaskia.edu/covid19/,17027,1229,Primarily Online,217,1446
Johnson & Wales University-North Miami,414823,"Primarily online, some courses in person",https://covid.jwu.edu/?_ga=2.31305151.1670403053.1594419142-353712309.1594419142,12086,1234,Primarily Online,158,1392
Northeast Lakeview College,488730,"Primarily online, some courses in person",https://www.alamo.edu/nlc/news-events/covid-19-info/,48029,1235,Primarily Online,254,1489
Carlow University,211431,"Primarily online, some courses in person",https://www.carlow.edu/coronavirus.aspx,42003,1246,Primarily Online,354,1600
Wayne Community College,199892,"Primarily online, some courses in person",https://www.waynecc.edu/safe-wayne/current-health-threats/,37191,1247,Primarily Online,415,1662
Ashland Community and Technical College,156231,"Primarily online, some courses in person",https://www.asbury.edu/covid19plan/,21019,1261,Primarily Online,195,1456
West Virginia Wesleyan College,237969,"Primarily online, some courses in person",https://www.wvwc.edu/campus-life/campus-safety-security/return-to-campus-plan/,54097,1266,Primarily Online,257,1523
City Colleges of Chicago-Kennedy-King College,144157,"Primarily online, some courses in person",https://prepare.ccc.edu/,17031,1267,Primarily Online,303,1570
Gateway Community and Technical College,157438,"Primarily online, some courses in person",https://gateway.kctcs.edu/healthy-at-gateway/index.aspx,21015,1270,Primarily Online,272,1542
Mount Saint Joseph University,204200,"Primarily online, some courses in person",http://www.msj.edu/audiences/covid-19-campus-updates/index.html,39061,1271,Primarily Online,407,1678
Three Rivers Community College,129808,"Primarily online, some courses in person",https://www.threerivers.edu/student-life/campus-safety/coronavirus/,09011,1274,Primarily Online,232,1506
Quincy College,167525,"Primarily online, some courses in person",https://quincycollege.edu/health-info/,25021,1275,Primarily Online,234,1509
St Clair County Community College,172291,"Primarily online, some courses in person",https://sc4.edu/coronavirus/,26147,1290,Primarily Online,239,1529
Alvin Community College,222567,"Primarily online, some courses in person",http://www.alvincollege.edu/announcements/covid-19/screening-procedures.html,48039,1302,Primarily Online,458,1760
Atlanta Technical College,138840,"Primarily online, some courses in person",https://atlantatech.edu/about-atc/covid-19-resources/,13121,1303,Primarily Online,321,1624
Central Carolina Technical College,218858,"Primarily online, some courses in person",https://www.cctech.edu/coronavirus/,45085,1305,Primarily Online,286,1591
Asbury University,156213,"Primarily online, some courses in person",https://www.asbury.edu/covid19plan/,21113,1316,Primarily Online,347,1663
Regis College,167598,"Primarily online, some courses in person",https://www.regiscollege.edu/regis-life/health-services/covid-19-coronavirus-information,25017,1320,Primarily Online,479,1799
Lackawanna College,213376,"Primarily online, some courses in person",https://www.lackawanna.edu/coronavirus-information/,42069,1326,Primarily Online,278,1604
Central Virginia Community College,231697,"Primarily online, some courses in person",https://centralvirginia.edu/COVID-19,51680,1328,Primarily Online,234,1562
Compton College,112686,"Primarily online, some courses in person",http://www.compton.edu//adminandoperations/campuspolice/covid-19.aspx,06037,1328,Primarily Online,327,1655
Aquinas College,168786,"Primarily online, some courses in person",https://www.aquinas.edu/resources/saints-together,26081,1333,Primarily Online,313,1646
Mid Michigan College,171155,"Primarily online, some courses in person",https://www.midmich.edu/campus-life/safety-security/incident-update/covid-19,26035,1336,Primarily Online,194,1530
Lee College,226204,"Primarily online, some courses in person",http://www.lee.edu/coronavirus/,48201,1339,Primarily Online,518,1857
Dakota County Technical College,173416,"Primarily online, some courses in person",https://www.dctc.edu/support-services/health-services/coronavirus/,27037,1343,Primarily Online,191,1534
College of Marin,118347,"Primarily online, some courses in person",http://www1.marin.edu/news/coronavirus-covid-19-updates-and-resources,06041,1345,Primarily Online,390,1735
Chowan University,198303,"Primarily online, some courses in person",https://www.chowan.edu/news/novel-coronavirus-2019-covid-19-information,37091,1356,Primarily Online,200,1556
Coastline Community College,112385,"Primarily online, some courses in person",https://www.coastline.edu/covid-19/index.php,06059,1370,Primarily Online,329,1699
Durham Technical Community College,198455,"Primarily online, some courses in person",https://www.durhamtech.edu/coronavirus,37063,1376,Primarily Online,610,1986
Northland Community and Technical College,174473,"Primarily online, some courses in person",http://www.northlandcollege.edu/safety/coronavirus/,27113,1376,Primarily Online,194,1570
South Central College,173911,"Primarily online, some courses in person",http://southcentral.edu/About/coronavirus.html?ID=track_covid19_hdr_link,27103,1382,Primarily Online,234,1616
Cedar Valley College,223773,"Primarily online, some courses in person",https://www.dcccd.edu/coronavirus/pages/default.aspx?utm_source=shortcut+url&utm_medium=redirect&utm_campaign=community&utm_term=coronavirus,48113,1395,Primarily Online,377,1772
University of Maine at Augusta,161217,"Primarily online, some courses in person",https://www.maine.edu/together/,23011,1406,Primarily Online,356,1762
West Virginia University at Parkersburg,237686,"Primarily online, some courses in person",https://www.wvup.edu/coronavirus/,54107,1407,Primarily Online,239,1646
University of Mount Olive,199069,"Primarily online, some courses in person",https://umo.edu/covid19response/,37191,1410,Primarily Online,324,1734
Ulster County Community College,196699,"Primarily online, some courses in person",https://www.sunyulster.edu/campus_and_culture/covid-19-hub/index.php,36111,1420,Primarily Online,250,1670
Gaston College,198570,"Primarily online, some courses in person",https://www.gaston.edu/about-us/campus-police-safety-home/emergency-preparedness-emergency-response-guide-erg/coronavirus/,37071,1430,Primarily Online,525,1955
Whitman College,237057,"Primarily online, some courses in person",https://www.whitman.edu/health-center/coronavirus-information,53071,1436,Primarily Online,528,1964
Community College of Aurora,126863,"Primarily online, some courses in person",https://www.ccaurora.edu/coronavirus,08005,1439,Primarily Online,336,1775
Muskegon Community College,171304,"Primarily online, some courses in person",https://www.muskegoncc.edu/coronavirus,26121,1445,Primarily Online,282,1727
Bevill State Community College,102429,"Primarily online, some courses in person",https://www.bscc.edu/coronavirus,01127,1455,Primarily Online,381,1836
Big Bend Community College,234711,"Primarily online, some courses in person",https://www.bigbend.edu/covid-19/,53025,1456,Primarily Online,214,1670
Southeast Kentucky Community and Technical College,157739,"Primarily online, some courses in person",https://southeast.kctcs.edu/covid-19/,21095,1460,Primarily Online,232,1692
Cisco College,223898,"Primarily online, some courses in person",https://www.cisco.edu/covid-19-updates,48133,1466,Primarily Online,250,1716
New Mexico Institute of Mining and Technology,187967,"Primarily online, some courses in person",https://nmt.edu/covid19/index.php,35053,1475,Primarily Online,797,2272
NHTI-Concord's Community College,183099,"Primarily online, some courses in person",https://www.nhti.edu/novel-coronavirus-covid-19/,33013,1478,Primarily Online,353,1831
California Institute of the Arts,111081,"Primarily online, some courses in person",https://calarts.edu/coronavirus-information-and-updates/overview,06037,1487,Primarily Online,444,1931
Concordia College-New York,190248,"Primarily online, some courses in person",https://www.concordia-ny.edu/coronavirus-updates,36119,1490,Primarily Online,245,1735
Lower Columbia College,235750,"Primarily online, some courses in person",https://lowercolumbia.edu/safety/covid-19.php,53015,1492,Primarily Online,350,1842
Owensboro Community and Technical College,247940,"Primarily online, some courses in person",https://owensboro.kctcs.edu/covid-19/,21059,1519,Primarily Online,243,1762
Ringling College of Art and Design,136774,"Primarily online, some courses in person",https://www.ringling.edu/fallupdates,12115,1519,Primarily Online,395,1914
Sandhills Community College,199634,"Primarily online, some courses in person",https://www.sandhills.edu/coronavirus-updates/,37125,1519,Primarily Online,447,1966
Northwestern Oklahoma State University,207306,"Primarily online, some courses in person",https://www.nwosu.edu/coronavirus,40151,1523,Primarily Online,266,1789
Nyack College,194161,"Primarily online, some courses in person",https://www.nyack.edu/site/coronavirus-updates/,36061,1524,Primarily Online,224,1748
Ouachita Baptist University,107512,"Primarily online, some courses in person",http://www.nwacc.edu/administrativeservices/riskmanagement/emergencypreparedness/coronavirus/,05019,1529,Primarily Online,306,1835
Hill College,225371,"Primarily online, some courses in person",https://www.hillcollege.edu/Safety/COVID-19.html,48217,1541,Primarily Online,270,1811
Roberts Wesleyan College,194958,"Primarily online, some courses in person",https://www.roberts.edu/roberts-restart,36055,1541,Primarily Online,282,1823
Waukesha County Technical College,240125,"Primarily online, some courses in person",https://www.wctc.edu/campus-life/safety-policies/coronavirus/index.php,55133,1544,Primarily Online,653,2197
Swarthmore College,216287,"Primarily online, some courses in person",https://www.swarthmore.edu/coronavirus-disease-2019-covid-19-information,42045,1554,Primarily Online,926,2480
St Philip's College,227854,"Primarily online, some courses in person",https://www.alamo.edu/coronavirus/,48029,1556,Primarily Online,629,2185
Georgian Court University,184773,"Primarily online, some courses in person",https://georgian.edu/health-services/coronavirus/,34029,1566,Primarily Online,365,1931
Alamance Community College,199786,"Primarily online, some courses in person",https://www.alamancecc.edu/health-alert/,37001,1581,Primarily Online,401,1982
Midland College,226806,"Primarily online, some courses in person",https://www.midland.edu/about/covid-19/index.php,48329,1584,Primarily Online,496,2080
Neumann University,214272,"Primarily online, some courses in person",https://www.neumann.edu/life/campus-plans,42045,1587,Primarily Online,323,1910
Evangel University,177339,"Primarily online, some courses in person",https://www.evangel.edu/coronavirus/,29077,1589,Primarily Online,366,1955
North Dakota State College of Science,200305,"Primarily online, some courses in person",https://www.ndscs.edu/covid-19-coronavirus-information,38077,1589,Primarily Online,321,1910
Laramie County Community College,240620,"Primarily online, some courses in person",https://lccc.wy.edu/virus-information.aspx,56021,1597,Primarily Online,455,2052
El Centro College,224615,"Primarily online, some courses in person",https://www.dcccd.edu/coronavirus/pages/default.aspx?utm_source=shortcut+url&utm_medium=redirect&utm_campaign=community&utm_term=coronavirus,48113,1601,Primarily Online,564,2165
Missouri Baptist University,178244,"Primarily online, some courses in person",https://www.mobap.edu/coronavirus-advisory/,29189,1608,Primarily Online,339,1947
Robert Morris University Illinois,148335,"Primarily online, some courses in person",https://blogs.roosevelt.edu/coronavirus/,17031,1619,Primarily Online,219,1838
Black Hawk College,143279,"Primarily online, some courses in person",https://www.bhc.edu/coronavirus-information-and-resources,17161,1625,Primarily Online,355,1980
Merritt College,118772,"Primarily online, some courses in person",https://www.merritt.edu/wp/blog/update-on-covid-19/,06001,1626,Primarily Online,216,1842
Oklahoma State University-Oklahoma City,207397,"Primarily online, some courses in person",https://osuokc.edu/safety,40109,1628,Primarily Online,318,1946
Berea College,156295,"Primarily online, some courses in person",https://www.berea.edu/coronavirus/,21151,1631,Primarily Online,845,2476
Cascadia College,439190,"Primarily online, some courses in person",http://www.cascadia.edu/services/emergency/coronavirus.aspx,53033,1644,Primarily Online,174,1818
Lawson State Community College,101569,"Primarily online, some courses in person",http://www.ls.cc.al.us/email_announcements/coronavirus_info.aspx,01073,1645,Primarily Online,282,1927
Yavapai College,106148,"Primarily online, some courses in person",https://www.yc.edu/v6/college-police/covid-19/,04025,1646,Primarily Online,523,2169
Centralia College,234845,"Primarily online, some courses in person",https://www.centralia.edu/about/news/covid-19.aspx,53041,1649,Primarily Online,279,1928
Pittsburgh Technical College,215415,"Primarily online, some courses in person",https://ptcollege.edu/public-safety/,42003,1651,Primarily Online,239,1890
New River Community College,232867,"Primarily online, some courses in person",https://www.nr.edu/ciu/,51155,1653,Primarily Online,180,1833
McDaniel College,164270,"Primarily online, some courses in person",https://www.mcdaniel.edu/about-us/campus-safety/return-hill-rtth,24013,1654,Primarily Online,564,2218
Sarah Lawrence College,195304,"Primarily online, some courses in person",https://www.sarahlawrence.edu/fall-2020/,36119,1655,Primarily Online,439,2094
Central Lakes College-Brainerd,173203,"Primarily online, some courses in person",http://www.clcmn.edu/covid-19/,27035,1661,Primarily Online,201,1862
Johnson & Wales University-Charlotte,445708,"Primarily online, some courses in person",https://covid.jwu.edu/?_ga=2.160543677.181301795.1594321972-495012577.1594321972,37119,1661,Primarily Online,187,1848
Lake-Sumter State College,135188,"Primarily online, some courses in person",https://www.lssc.edu/safety/coronavirus/,12069,1671,Primarily Online,286,1957
Inver Hills Community College,173799,"Primarily online, some courses in person",https://www.inverhills.edu/COVID-19/index.aspx,27037,1672,Primarily Online,232,1904
American Musical and Dramatic Academy,188854,"Primarily online, some courses in person",https://www.amda.edu/coronavirus,36061,1676,Primarily Online,369,2045
Vanguard University of Southern California,123651,"Primarily online, some courses in person",https://www.vanguard.edu/coronavirus,06059,1677,Primarily Online,300,1977
Housatonic Community College,129543,"Primarily online, some courses in person",https://www.housatonic.edu/covid-19,09001,1684,Primarily Online,292,1976
Illinois Wesleyan University,145646,"Primarily online, some courses in person",https://www.iwu.edu/updates/coronavirus/,17113,1689,Primarily Online,456,2145
Northern Essex Community College,167376,"Primarily online, some courses in person",https://www.necc.mass.edu/public-safety/coronavirus-information/,25009,1698,Primarily Online,498,2196
Western Technical College,240170,"Primarily online, some courses in person",https://www.westerntc.edu/coronavirus,55063,1709,Primarily Online,633,2342
University of Hawaii-West Oahu,141981,"Primarily online, some courses in person",https://westoahu.hawaii.edu/covid-19/guidelines/,15003,1711,Primarily Online,293,2004
Lawrence Technological University,170675,"Primarily online, some courses in person",https://www.ltu.edu/coronavirus/,26125,1714,Primarily Online,444,2158
Kenyon College,203535,"Primarily online, some courses in person",https://www.kenyon.edu/covid19-update/,39083,1721,Primarily Online,638,2359
College of the Redwoods,121707,"Primarily online, some courses in person",https://www.redwoods.edu/covid19,06023,1725,Primarily Online,319,2044
Schenectady County Community College,195322,"Primarily online, some courses in person",https://sunysccc.edu/About-Us/Campus-Safety/Coronavirus,36093,1729,Primarily Online,282,2011
Lincoln University,177940,"Primarily online, some courses in person",https://www.lincoln.edu/departments/health-services/coronavirus,29051,1730,Primarily Online,397,2127
Norwalk Community College,130004,"Primarily online, some courses in person",https://norwalk.edu/covid-19/,09001,1737,Primarily Online,293,2030
Lake Washington Institute of Technology,235699,"Primarily online, some courses in person",https://www.lwtech.edu/news/coronavirus-covid-19-information-and-resources/,53033,1745,Primarily Online,303,2048
Western Iowa Tech Community College,154572,"Primarily online, some courses in person",https://www.witcc.edu/covid19/,19193,1746,Primarily Online,434,2180
Indiana Institute of Technology,151290,"Primarily online, some courses in person",https://www.indianatech.edu/coronavirus/,18003,1758,Primarily Online,471,2229
Eastern Gateway Community College,203331,"Primarily online, some courses in person",https://egcc.edu/covid-19/,39081,1765,Primarily Online,520,2285
Kent State University at Stark,203465,"Primarily online, some courses in person",https://www.kent.edu/stark/coronavirus-updates-stark,39151,1768,Primarily Online,282,2050
Gavilan College,114938,"Primarily online, some courses in person",https://www.gavilan.edu/news/COVID19_2020/index.php,06085,1775,Primarily Online,283,2058
Whittier College,125763,"Primarily online, some courses in person",https://www.whittier.edu/covid19,06037,1779,Primarily Online,403,2182
Brookhaven College,223524,"Primarily online, some courses in person",https://www.dcccd.edu/coronavirus/pages/default.aspx?utm_source=shortcut+url&utm_medium=redirect&utm_campaign=community&utm_term=coronavirus,48113,1795,Primarily Online,628,2423
Rockhurst University,179043,"Primarily online, some courses in person",https://www.rockhurst.edu/coronavirus,29095,1796,Primarily Online,390,2186
Jefferson Community College,192022,"Primarily online, some courses in person",https://www.sunyjefferson.edu/coronavirus/,36045,1802,Primarily Online,252,2054
Nevada State College,441900,"Primarily online, some courses in person",https://nsc.edu/coronavirus/,32003,1805,Primarily Online,367,2172
Chicago State University,144005,"Primarily online, some courses in person",https://www.csu.edu/covid19updates/,17031,1810,Primarily Online,638,2448
Bowdoin College,161004,"Primarily online, some courses in person",https://www.bowdoin.edu/covid-19/,23005,1825,Primarily Online,954,2779
Westmoreland County Community College,216825,"Primarily online, some courses in person",https://westmoreland.edu/resources/coronavirus.html,42129,1825,Primarily Online,380,2205
Porterville College,121363,"Primarily online, some courses in person",https://www.portervillecollege.edu/important-updates-and-notices,06107,1828,Primarily Online,195,2023
Langston University,207209,"Primarily online, some courses in person",https://www.langston.edu/healthclinic/covid19,40083,1831,Primarily Online,332,2163
Southwest Texas Junior College,228316,"Primarily online, some courses in person",https://swtjc.edu/about/coronavirus-covid19/faqs-coronavirus.html,48463,1836,Primarily Online,413,2249
Manhattanville College,192749,"Primarily online, some courses in person",https://www.mville.edu/content/covid-19-information-manhattanville-community,36119,1839,Primarily Online,410,2249
Ridgewater College,175236,"Primarily online, some courses in person",https://www.ridgewater.edu/covid-19/,27067,1839,Primarily Online,230,2069
Hennepin Technical College,173708,"Primarily online, some courses in person",https://www.hennepintech.edu/coronavirus_21.html,27053,1853,Primarily Online,300,2153
Amherst College,164465,"Primarily online, some courses in person",https://www.amherst.edu/news/covid-19,25015,1855,Primarily Online,996,2851
Virginia Western Community College,233949,"Primarily online, some courses in person",https://www.virginiawestern.edu/covid19/,51770,1858,Primarily Online,332,2190
Marymount Manhattan College,192864,"Primarily online, some courses in person",https://www.mmm.edu/offices/dow-zanghi-health-center/updates-regarding-coronavirus-covid-19/mmcs-actions/index.php,36061,1861,Primarily Online,397,2258
New Mexico Highlands University,187897,"Primarily online, some courses in person",https://www.nmhu.edu/coronavirus-covid-19-information/,35047,1874,Primarily Online,480,2354
North Seattle College,236072,"Primarily online, some courses in person",https://northseattle.edu/coronavirus,53033,1874,Primarily Online,365,2239
Coastal Carolina Community College,198330,"Primarily online, some courses in person",https://www.coastalcarolina.edu/news/article/community-resources/,37133,1877,Primarily Online,420,2297
Heartland Community College,384342,"Primarily online, some courses in person",http://www.heartland.edu/coronavirus/,17113,1884,Primarily Online,367,2251
University of Wisconsin-Superior,240426,"Primarily online, some courses in person",https://www.uwsuper.edu/ehs/coronavirus/index.cfm,55031,1889,Primarily Online,346,2235
Mission College,118930,"Primarily online, some courses in person",http://www.missioncollege.edu/student_services/health-services/health-warnings.html,06085,1902,Primarily Online,441,2343
South Seattle College,236504,"Primarily online, some courses in person",https://southseattle.edu/coronavirus,53033,1911,Primarily Online,326,2237
Mott Community College,169275,"Primarily online, some courses in person",https://www.mcc.edu/campus-safety/covid-19-coronavirus.shtml,26049,1914,Primarily Online,513,2427
Contra Costa College,112826,"Primarily online, some courses in person",http://www.4cd.edu/covid19/default.aspx,06013,1921,Primarily Online,294,2215
Jamestown Community College,191986,"Primarily online, some courses in person",https://www.sunyjcc.edu/student-experience/services-support/college-health-services/coronavirus,36013,1935,Primarily Online,359,2294
College of Southern Idaho,142559,"Primarily online, some courses in person",https://www.csi.edu/coronavirus/,16083,1937,Primarily Online,676,2613
Crowder College,177135,"Primarily online, some courses in person",https://www.crowder.edu/covid-19/,29145,1943,Primarily Online,414,2357
Bay Path University,164632,"Primarily online, some courses in person",https://www.baypath.edu/student-life/health-wellness/coronavirus/%20,25013,1955,Primarily Online,420,2375
Lord Fairfax Community College,232575,"Primarily online, some courses in person",https://lfcc.edu/novel-coronavirus-covid-19-prevention-response/#statement,51069,1967,Primarily Online,352,2319
Shelton State Community College,102067,"Primarily online, some courses in person",https://www.sheltonstate.edu/about-us/emergency-preparedness/covid-19-coronavirus-information/,01125,1973,Primarily Online,337,2310
Indian Hills Community College,153472,"Primarily online, some courses in person",http://www.indianhills.edu/about/covid.php,19179,1976,Primarily Online,464,2440
Jefferson College,177676,"Primarily online, some courses in person",https://www.jeffco.edu/covid-19,29099,1989,Primarily Online,329,2318
Harford Community College,162706,"Primarily online, some courses in person",http://www.harford.edu/about/news/2020/coronavirus.aspx,24025,1993,Primarily Online,561,2554
North Shore Community College,167312,"Primarily online, some courses in person",https://www.northshore.edu/corona/,25009,1996,Primarily Online,578,2574
Manchester Community College,129695,"Primarily online, some courses in person",https://www.ccsnh.edu/covid-19/,09003,2004,Primarily Online,361,2365
Wayne County Community College District,172635,"Primarily online, some courses in person",http://www.wcccd.edu/coronavirus.html,26163,2005,Primarily Online,714,2719
Napa Valley College,119331,"Primarily online, some courses in person",http://www.napavalley.edu/emergency/Pages/emergencyhome.aspx,06055,2006,Primarily Online,391,2397
SUNY College of Environmental Science and Forestry,196103,"Primarily online, some courses in person",https://www.esf.edu/coronavirus/,36067,2007,Primarily Online,419,2426
Lakeland Community College,203599,"Primarily online, some courses in person",http://www.lakelandcc.edu/web/about/notices/coronavirus,39085,2011,Primarily Online,519,2530
University of the Sciences,215132,"Primarily online, some courses in person",https://www.usciences.edu/student-life/student-health-and-counseling/covid-19/index.html,42101,2011,Primarily Online,482,2493
Bates Technical College,235671,"Primarily online, some courses in person",https://www.batestech.edu/bates-and-the-coronavirus/,53053,2033,Primarily Online,283,2316
Daemen College,190725,"Primarily online, some courses in person",https://www.daemen.edu/about/campus/campus-safety/emergency-management-plan/daemen-preparedness,36029,2062,Primarily Online,443,2505
West Kentucky Community and Technical College,157483,"Primarily online, some courses in person",https://westkentucky.meritpages.com/news/wkctc-answering-questions-online-about-support-services-and-fall-semester/16110,21145,2062,Primarily Online,357,2419
North Hennepin Community College,174376,"Primarily online, some courses in person",https://www.nhcc.edu/covid19,27053,2063,Primarily Online,290,2353
City Colleges of Chicago-Harry S Truman College,144184,"Primarily online, some courses in person",https://prepare.ccc.edu/,17031,2064,Primarily Online,379,2443
York Technical College,218991,"Primarily online, some courses in person",https://yorktech.edu/Coronavirus-Information/,45091,2065,Primarily Online,404,2469
Palo Alto College,246354,"Primarily online, some courses in person",https://www.alamo.edu/coronavirus/,48029,2075,Primarily Online,454,2529
Copiah-Lincoln Community College,175573,"Primarily online, some courses in person",https://www.colin.edu/about/coronavirus/,28029,2087,Primarily Online,323,2410
University of Houston-Victoria,225502,"Primarily online, some courses in person",https://www.uhv.edu/covid-19/communications/course-modes-for-fall-student-july-30/,48469,2088,Primarily Online,438,2526
Adirondack Community College,188438,"Primarily online, some courses in person",https://www.sunyacc.edu/fall-2020,36113,2090,Primarily Online,321,2411
Rio Salado College,105668,"Primarily online, some courses in person",https://www.maricopa.edu/coronavirus-covid-19,04013,2090,Primarily Online,824,2914
Spartanburg Community College,218830,"Primarily online, some courses in person",https://www.sccsc.edu/coronavirus.php,45083,2105,Primarily Online,410,2515
Mississippi University for Women,176035,"Primarily online, some courses in person",https://www.muw.edu/disease,28087,2109,Primarily Online,356,2465
University of the District of Columbia,131399,"Primarily online, some courses in person",https://www.udc.edu/covid-19/,11001,2110,Primarily Online,831,2941
Saint Norbert College,239716,"Primarily online, some courses in person",https://www.snc.edu/covid19/,55009,2113,Primarily Online,592,2705
Southwest Minnesota State University,175078,"Primarily online, some courses in person",https://www.smsu.edu/campuslife/healthservices/healthalerts/coronavirus.html,27083,2116,Primarily Online,318,2434
Chippewa Valley Technical College,240116,"Primarily online, some courses in person",https://www.cvtc.edu/about-cvtc/consumer-disclosures/health-advisory-updates,55035,2123,Primarily Online,545,2668
Norco College,460464,"Primarily online, some courses in person",https://www.rccd.edu/admin/bfs/risk/Pages/covid_19.aspx,06065,2145,Primarily Online,343,2488
Palmer College of Chiropractic,154174,"Primarily online, some courses in person",https://blogs.palmer.edu/profiles/2020/03/10/coronavirus-covid-19-update/?_ga=2.161088061.1027296564.1594390957-193358240.1594390957,19163,2147,Primarily Online,435,2582
St Cloud Technical and Community College,174756,"Primarily online, some courses in person",https://www.sctcc.edu/covid-19-updates,27145,2149,Primarily Online,240,2389
Moody Bible Institute,147369,"Primarily online, some courses in person",https://www.moody.edu/fall-2020-semester-update,17031,2156,Primarily Online,449,2605
Paradise Valley Community College,364016,"Primarily online, some courses in person",https://www.maricopa.edu/coronavirus-covid-19,04013,2157,Primarily Online,436,2593
Arizona Western College,104160,"Primarily online, some courses in person",https://www.azwestern.edu/COVID,04027,2166,Primarily Online,700,2866
Naugatuck Valley Community College,129729,"Primarily online, some courses in person",https://www.nv.edu/Student-Life/Where-to-Go/Safety-Support/COVID-19-Information,09009,2181,Primarily Online,417,2598
Central Georgia Technical College,483045,"Primarily online, some courses in person",https://www.centralgatech.edu/covid-19,13153,2185,Primarily Online,690,2875
Lincoln Land Community College,146685,"Primarily online, some courses in person",https://www.llcc.edu/public-relations-marketing/covid-19-college-update/,17167,2196,Primarily Online,438,2634
Germanna Community College,232195,"Primarily online, some courses in person",https://www.germanna.edu/COVID-19/,51137,2199,Primarily Online,368,2567
Westminster College,230807,"Primarily online, some courses in person",https://www.wcmo.edu/student-life/wellness/covid-19-plan.html,49035,2199,Primarily Online,527,2726
Atlantic Cape Community College,183655,"Primarily online, some courses in person",http://www.atlantic.edu/coronavirus/,34001,2207,Primarily Online,394,2601
Cincinnati State Technical and Community College,201928,"Primarily online, some courses in person",https://www.cincinnatistate.edu/COVID-19,39061,2228,Primarily Online,552,2780
Scottsdale Community College,105747,"Primarily online, some courses in person",https://www.maricopa.edu/coronavirus-covid-19,04013,2229,Primarily Online,505,2734
St Francis College,195173,"Primarily online, some courses in person",https://www.sfc.edu/studentlife/studenthealth/covid19-guidance/faq,36047,2239,Primarily Online,378,2617
Cuyamaca College,113218,"Primarily online, some courses in person",https://www.cuyamaca.edu/covid19/,06073,2241,Primarily Online,384,2625
Asheville-Buncombe Technical Community College,197887,"Primarily online, some courses in person",https://abtech.edu/about/contact/coronavirus-covid-19-information,37021,2242,Primarily Online,645,2887
Holyoke Community College,166133,"Primarily online, some courses in person",https://www.hcc.edu/student-life/remote-resources/coronavirus-info,25013,2247,Primarily Online,562,2809
Southern Maine Community College,161545,"Primarily online, some courses in person",https://www.smccme.edu/about/coronavirus-covid-19/,23005,2250,Primarily Online,371,2621
Rochester Community and Technical College,174738,"Primarily online, some courses in person",https://www.rctc.edu/coronavirus/,27109,2255,Primarily Online,313,2568
University of North Texas at Dallas,484905,"Primarily online, some courses in person",https://www.untdallas.edu/covid-19-knowledge-center,48113,2256,Primarily Online,396,2652
Hawkeye Community College,153445,"Primarily online, some courses in person",https://www.hawkeyecollege.edu/COVID-19,19013,2258,Primarily Online,503,2761
Elizabethtown Community and Technical College,156648,"Primarily online, some courses in person",https://elizabethtown.kctcs.edu/covid-19/,21093,2286,Primarily Online,322,2608
Clover Park Technical College,234951,"Primarily online, some courses in person",https://cptc.edu/coronavirus-info,53053,2290,Primarily Online,275,2565
State Fair Community College,179539,"Primarily online, some courses in person",https://www.sfccmo.edu/campus-life/campus-life/public-health/,29159,2290,Primarily Online,316,2606
University of Arkansas at Pine Bluff,106412,"Primarily online, some courses in person",http://www.uapb.edu/coronavirus.aspx,05069,2291,Primarily Online,631,2922
Indiana University-Kokomo,151333,"Primarily online, some courses in person",https://coronavirus.iu.edu/,18067,2309,Primarily Online,327,2636
New England Institute of Technology,217305,"Primarily online, some courses in person",https://www.neit.edu/About-Us/COVID-19-Announcements,44003,2323,Primarily Online,359,2682
Moreno Valley College,460394,"Primarily online, some courses in person",https://www.rccd.edu/admin/bfs/risk/Pages/covid_19.aspx,06065,2338,Primarily Online,340,2678
Clovis Community College,489201,"Primarily online, some courses in person",http://www.clovis.edu/coronavirus/index.aspx,06019,2348,Primarily Online,249,2597
Rowan-Cabarrus Community College,199494,"Primarily online, some courses in person",https://www.rccc.edu/coronavirus/,37159,2349,Primarily Online,582,2931
Jackson State Community College,220400,"Primarily online, some courses in person",https://www.jscc.edu/covid/,47113,2350,Primarily Online,300,2650
Skyline College,123509,"Primarily online, some courses in person",https://covid-19.smccd.edu/,06081,2357,Primarily Online,359,2716
Oregon Institute of Technology,209506,"Primarily online, some courses in person",https://www.oit.edu/coronavirus,41035,2359,Primarily Online,477,2836
College of San Mateo,122791,"Primarily online, some courses in person",https://covid-19.smccd.edu/,06081,2363,Primarily Online,355,2718
Clackamas Community College,208406,"Primarily online, some courses in person",https://www.clackamas.edu/coronavirus,41005,2368,Primarily Online,559,2927
Whatcom Community College,237039,"Primarily online, some courses in person",https://www.whatcom.edu/about-the-college/news-media/covid-19-information-and-resources,53073,2368,Primarily Online,350,2718
Lesley University,166452,"Primarily online, some courses in person",https://lesley.edu/students/health-wellness-safety/coronavirus-disease-2019-covid-19-information,25017,2369,Primarily Online,635,3004
University of Illinois at Springfield,148654,"Primarily online, some courses in person",https://www.uis.edu/covid-19/,17167,2369,Primarily Online,752,3121
Meridian Community College,175935,"Primarily online, some courses in person",https://meridiancc.edu/coronavirus/index.html,28075,2374,Primarily Online,377,2751
San Juan College,188100,"Primarily online, some courses in person",https://www.sanjuancollege.edu/coronavirus/,35045,2374,Primarily Online,683,3057
Finger Lakes Community College,191199,"Primarily online, some courses in person",https://www.flcc.edu/health-update/,36069,2377,Primarily Online,407,2784
Wellesley College,168218,"Primarily online, some courses in person",https://www.wellesley.edu/coronavirus,25021,2391,Primarily Online,1121,3512
Saint Paul College,175041,"Primarily online, some courses in person",https://www.saintpaul.edu/covid-19,27123,2408,Primarily Online,333,2741
NorthWest Arkansas Community College,367459,"Primarily online, some courses in person",https://www.nwacc.edu/administrativeservices/riskmanagement/emergencypreparedness/coronavirus/,05007,2426,Primarily Online,539,2965
John Tyler Community College,232450,"Primarily online, some courses in person",https://www.jtcc.edu/about/safety-security/covid-19/,51041,2431,Primarily Online,413,2844
Thomas Nelson Community College,233754,"Primarily online, some courses in person",https://tncc.edu/emergency-preparedness,51650,2447,Primarily Online,442,2889
J Sargeant Reynolds Community College,232414,"Primarily online, some courses in person",http://www.reynolds.edu/campus_life/health/health.aspx,51087,2453,Primarily Online,532,2985
Arcadia University,211088,"Primarily online, some courses in person",https://www.arcadia.edu/planning-fall-return-campus/coronavirus,42091,2456,Primarily Online,694,3150
Minneapolis Community and Technical College,174136,"Primarily online, some courses in person",https://www.minneapolis.edu/covid-19-information,27053,2457,Primarily Online,391,2848
New England College,182980,"Primarily online, some courses in person",https://www.nec.edu/coronavirus/,33013,2462,Primarily Online,465,2927
Lehigh Carbon Community College,213525,"Primarily online, some courses in person",https://www.lccc.edu/alerts/home,42077,2463,Primarily Online,432,2895
Red Rocks Community College,127909,"Primarily online, some courses in person",https://www.rrcc.edu/cdphe-coronavirus,08059,2477,Primarily Online,469,2946
College of Southern Maryland,162122,"Primarily online, some courses in person",https://ready.csmd.edu/covid-19/,24017,2490,Primarily Online,570,3060
SUNY College of Technology at Delhi,196024,"Primarily online, some courses in person",https://www.delhi.edu/covid19/,36025,2522,Primarily Online,474,2996
Oakton Community College,147800,"Primarily online, some courses in person",https://www.oakton.edu/newsevents/news/alerts/coronavirus.php,17031,2538,Primarily Online,644,3182
Quinsigamond Community College,167534,"Primarily online, some courses in person",https://www.qcc.edu/services/health-wellness/coronavirus-covid-19,25027,2539,Primarily Online,669,3208
Somerset Community College,157711,"Primarily online, some courses in person",https://somerset.kctcs.edu/covid-19/,21199,2542,Primarily Online,381,2923
Skagit Valley College,236638,"Primarily online, some courses in person",https://www.skagit.edu/about/safety-security-parking/coronavirus-information/,53057,2546,Primarily Online,444,2990
Linn-Benton Community College,209074,"Primarily online, some courses in person",https://www.linnbenton.edu/about-lbcc/college-services/safety/covid19/index.php,41043,2571,Primarily Online,588,3159
Northeast Wisconsin Technical College,239488,"Primarily online, some courses in person",https://www.nwtc.edu/about-nwtc/news/emergency-information,55009,2573,Primarily Online,832,3405
Leeward Community College,141811,"Primarily online, some courses in person",http://intranet.leeward.hawaii.edu/Covid19-faculty-resources,15003,2586,Primarily Online,373,2959
Kalamazoo Valley Community College,170541,"Primarily online, some courses in person",https://www.kvcc.edu/coronavirus/,26077,2604,Primarily Online,666,3270
Mercer County Community College,185509,"Primarily online, some courses in person",https://www.mccc.edu/mccchealth_resources.shtml,34021,2608,Primarily Online,583,3191
Del Mar College,224350,"Primarily online, some courses in person",https://www.delmar.edu/rtc/index.html,48355,2610,Primarily Online,953,3563
Passaic County Community College,186034,"Primarily online, some courses in person",https://newweb.pccc.edu/coronavirus/,34031,2610,Primarily Online,549,3159
Laney College,117247,"Primarily online, some courses in person",https://laney.edu/blog/updates-on-covid-19/,06001,2613,Primarily Online,354,2967
West Valley College,125499,"Primarily online, some courses in person",https://www.westvalley.edu/covid-19/,06085,2614,Primarily Online,507,3121
Indiana Institute of Technology-College of Professions Studies,492962,"Primarily online, some courses in person",https://www.indianatech.edu/coronavirus/,18003,2637,Primarily Online,0,2637
Indiana University-Northwest,151360,"Primarily online, some courses in person",https://coronavirus.iu.edu/,18089,2641,Primarily Online,434,3075
Pierce College-Fort Steilacoom,235237,"Primarily online, some courses in person",https://www.pierce.ctc.edu/coronavirus,53053,2643,Primarily Online,353,2996
University of Hawaii at Hilo,141565,"Primarily online, some courses in person",https://hilo.hawaii.edu/covid19/,15001,2644,Primarily Online,554,3198
Phoenix College,105428,"Primarily online, some courses in person",https://www.maricopa.edu/coronavirus-covid-19,04013,2645,Primarily Online,668,3313
Waubonsee Community College,149727,"Primarily online, some courses in person",https://www.waubonsee.edu/covid19,17089,2651,Primarily Online,644,3295
Massasoit Community College,166823,"Primarily online, some courses in person",https://massasoit.edu/public-health-information-covid-19/,25023,2652,Primarily Online,574,3226
Gwynedd Mercy University,212832,"Primarily online, some courses in person",https://www.gmercyu.edu/covid-19,42091,2654,Primarily Online,446,3100
Jefferson State Community College,101505,"Primarily online, some courses in person",https://www.jeffersonstate.edu/covid-19info/,01073,2659,Primarily Online,511,3170
Abraham Baldwin Agricultural College,138558,"Primarily online, some courses in person",https://www.abac.edu/coronavirus/,13277,2660,Primarily Online,428,3088
Solano Community College,123563,"Primarily online, some courses in person",http://www.solano.edu/coronavirus/,06095,2689,Primarily Online,410,3099
Wilkes University,216931,"Primarily online, some courses in person",https://www.wilkes.edu/news/index.aspx,42079,2693,Primarily Online,749,3442
Lorain County Community College,203748,"Primarily online, some courses in person",https://www.lorainccc.edu/security/coronavirus/,39093,2737,Primarily Online,726,3463
Augsburg University,173045,"Primarily online, some courses in person",https://www.augsburg.edu/bold/,27053,2748,Primarily Online,600,3348
City Colleges of Chicago-Richard J Daley College,144193,"Primarily online, some courses in person",https://prepare.ccc.edu/,17031,2761,Primarily Online,302,3063
Rock Valley College,148380,"Primarily online, some courses in person",https://www.rockvalleycollege.edu/Academics/Fall-2020-Semester-FAQ.cfm,17201,2762,Primarily Online,473,3235
San Diego Miramar College,122384,"Primarily online, some courses in person",http://www.sdmiramar.edu/covid-info,06073,2769,Primarily Online,378,3147
Eastfield College,224572,"Primarily online, some courses in person",https://www.dcccd.edu/coronavirus/pages/default.aspx?utm_source=shortcut+url&utm_medium=redirect&utm_campaign=community&utm_term=coronavirus,48113,2783,Primarily Online,613,3396
St Catherine University,175005,"Primarily online, some courses in person",https://www.stkate.edu/coronavirus-info,27123,2788,Primarily Online,733,3521
St. Joseph's College-Long Island,195562,"Primarily online, some courses in person",https://www.sjcny.edu/em/reopening,36103,2801,Primarily Online,447,3248
Fairleigh Dickinson University-Metropolitan Campus,184603,"Primarily online, some courses in person",https://www.fdu.edu/coronavirus-update/,34003,2802,Primarily Online,769,3571
Eastern New Mexico University-Main Campus,187648,"Primarily online, some courses in person",https://www.enmu.edu/covid-19-health-advisory,35041,2803,Primarily Online,524,3327
Charleston Southern University,217688,"Primarily online, some courses in person",https://www.charlestonsouthern.edu/category/covid-19/,45019,2811,Primarily Online,499,3310
South Puget Sound Community College,236656,"Primarily online, some courses in person",https://spscc.edu/covid-19,53067,2823,Primarily Online,366,3189
Henderson State University,107071,"Primarily online, some courses in person",https://www.hsu.edu/pages/coronavirus/,05019,2825,Primarily Online,444,3269
Husson University,487524,"Primarily online, some courses in person",https://www.husson.edu/return-to-campus/,23019,2829,Primarily Online,477,3306
City Colleges of Chicago-Malcolm X College,144166,"Primarily online, some courses in person",https://prepare.ccc.edu/,17031,2839,Primarily Online,419,3258
Delta College,169521,"Primarily online, some courses in person",https://www.delta.edu/coronavirus/,26017,2848,Primarily Online,597,3445
American International College,164447,"Primarily online, some courses in person",https://www.aic.edu/coronavirus-home/,25013,2852,Primarily Online,396,3248
Bucks County Community College,211307,"Primarily online, some courses in person",https://www.bucks.edu/coronavirus/,42017,2852,Primarily Online,679,3531
Wharton County Junior College,229841,"Primarily online, some courses in person",https://www.wcjc.edu/About-Us/administration/office-of-the-president/Coronavirus-Update/index.aspx,48481,2867,Primarily Online,447,3314
Parkland College,147916,"Primarily online, some courses in person",https://www.parkland.edu/Main/About-Parkland/Department-Office-Directory/Student-Life/Wellness-Center/COVID-19-Information,17019,2874,Primarily Online,532,3406
Mt Hood Community College,209250,"Primarily online, some courses in person",https://www.mhcc.edu/Coronavirus-Resources/,41051,2882,Primarily Online,546,3428
Babson College,164580,"Primarily online, some courses in person",https://www.babson.edu/emergency-preparedness/coronavirus/,25021,2905,Primarily Online,876,3781
Shoreline Community College,236610,"Primarily online, some courses in person",https://www.shoreline.edu/covid19.aspx,53033,2911,Primarily Online,448,3359
Truckee Meadows Community College,182500,"Primarily online, some courses in person",https://www.tmcc.edu/environmental-health-safety/coronavirus,32031,2927,Primarily Online,662,3589
Forsyth Technical Community College,198552,"Primarily online, some courses in person",https://www.forsythtech.edu/healthalert,37067,2931,Primarily Online,894,3825
Las Positas College,366401,"Primarily online, some courses in person",http://www.laspositascollege.edu/onlinecollege/resources.php,06001,2959,Primarily Online,323,3282
Niagara County Community College,193946,"Primarily online, some courses in person",http://niagaracc.suny.edu/coronavirus/,36063,2962,Primarily Online,438,3400
Orange County Community College,194240,"Primarily online, some courses in person",https://sunyorange.edu/covid-19/index.html,36071,2964,Primarily Online,626,3590
The Evergreen State College,235167,"Primarily online, some courses in person",https://www.evergreen.edu/covid19,53067,2973,Primarily Online,582,3555
Walters State Community College,222062,"Primarily online, some courses in person",https://www.ws.edu/coronavirus/#lu-20200626,47063,2995,Primarily Online,479,3474
Illinois Central College,145682,"Primarily online, some courses in person",https://icc.edu/about-icc/coronavirus-covid-19/,17179,3009,Primarily Online,642,3651
College of Central Florida,132851,"Primarily online, some courses in person",https://www.cf.edu/community/pr/college-update/,12083,3016,Primarily Online,538,3554
Yakima Valley College,237109,"Primarily online, some courses in person",https://www.yvcc.edu/services/coronavirus/,53077,3041,Primarily Online,423,3464
Elgin Community College,144944,"Primarily online, some courses in person",https://elgin.edu/about-ecc/campus-safety/emergency-management/,17089,3055,Primarily Online,674,3729
Santiago Canyon College,399212,"Primarily online, some courses in person",https://www.rsccd.edu/Coronavirus/Pages/default.aspx,06059,3056,Primarily Online,451,3507
San Diego City College,122339,"Primarily online, some courses in person",http://sdcity.edu/about/communications/covid19/,06073,3065,Primarily Online,499,3564
Triton College,149532,"Primarily online, some courses in person",https://www.triton.edu/info-pages/coronavirus-info/,17031,3069,Primarily Online,659,3728
Roosevelt University,148487,"Primarily online, some courses in person",https://blogs.roosevelt.edu/coronavirus/,17031,3082,Primarily Online,712,3794
Delaware County Community College,211927,"Primarily online, some courses in person",https://www.dccc.edu/coronavirus,42045,3083,Primarily Online,673,3756
Raritan Valley Community College,186645,"Primarily online, some courses in person",https://www.raritanval.edu/coronavirus,34035,3089,Primarily Online,504,3593
William Carey University,176479,"Primarily online, some courses in person",https://www.wmcarey.edu/page/coronavirus-update,28035,3103,Primarily Online,539,3642
Columbia State Community College,219888,"Primarily online, some courses in person",https://www.columbiastate.edu/coronavirus/index.html,47119,3110,Primarily Online,338,3448
Los Medanos College,117894,"Primarily online, some courses in person",https://www.losmedanos.edu/safety/tips.aspx,06013,3113,Primarily Online,368,3481
Estrella Mountain Community College,384333,"Primarily online, some courses in person",https://www.maricopa.edu/coronavirus-covid-19,04013,3115,Primarily Online,448,3563
The College of Saint Scholastica,174899,"Primarily online, some courses in person",http://www.css.edu/administration/safety-and-security/coronavirus.html,27137,3126,Primarily Online,616,3742
Stark State College,205841,"Primarily online, some courses in person",https://www.starkstate.edu/about/security/coronavirus/,39151,3140,Primarily Online,545,3685
University of Northwestern Ohio,204486,"Primarily online, some courses in person",https://www.unoh.edu/offices/safety-services/coronavirus.html,39003,3146,Primarily Online,354,3500
St. Mary's University,228149,"Primarily online, some courses in person",https://www.stmarytx.edu/emergency/,48029,3147,Primarily Online,709,3856
Mohawk Valley Community College,193283,"Primarily online, some courses in person",https://www.mvcc.edu/restart/responsible-restart-plan.php,36065,3161,Primarily Online,518,3679
Montgomery County Community College,214111,"Primarily online, some courses in person",https://www.mc3.edu/choosing-montco/resources-for-students/health-and-wellness/coronavirus,42091,3165,Primarily Online,681,3846
St Charles Community College,262031,"Primarily online, some courses in person",https://www.stchas.edu/lp/coronavirus/coronavirus-covid-19-information,29183,3167,Primarily Online,514,3681
Metropolitan State University,174020,"Primarily online, some courses in person",https://www.metrostate.edu/notices/covid-19,27123,3182,Primarily Online,656,3838
Cuesta College,113193,"Primarily online, some courses in person",https://www.cuesta.edu/covid-19.html,06079,3190,Primarily Online,515,3705
Saint Mary's College of California,123554,"Primarily online, some courses in person",https://www.stmarys-ca.edu/public-safety-transportation/faqs-saint-marys-response-to-and-prevention-of-covid-19,06013,3196,Primarily Online,870,4066
National Louis University,147536,"Primarily online, some courses in person",https://nl.edu/alert/,17031,3200,Primarily Online,783,3983
University of North Carolina at Asheville,199111,"Primarily online, some courses in person",https://drive.google.com/file/d/1CZiMK05jAMvsj0guDjJ19uK8x6RfP7XT/view,37021,3233,Primarily Online,714,3947
Prince George's Community College,163657,"Primarily online, some courses in person",https://www.pgcc.edu/coronavirus/,24033,3248,Primarily Online,1211,4459
John C Calhoun State Community College,101514,"Primarily online, some courses in person",https://calhoun.edu/coronavirus-information/,01083,3262,Primarily Online,543,3805
Itawamba Community College,175829,"Primarily online, some courses in person",http://www.iccms.edu/Coronavirus,28057,3270,Primarily Online,440,3710
Howard Community College,162779,"Primarily online, some courses in person",https://www.howardcc.edu/coronavirus/,24027,3271,Primarily Online,887,4158
University of Wisconsin-Parkside,240374,"Primarily online, some courses in person",https://www.uwp.edu/rangerrestart/,55059,3287,Primarily Online,487,3774
South Louisiana Community College,434061,"Primarily online, some courses in person",https://www.solacc.edu/updates,22055,3297,Primarily Online,482,3779
Loyola University New Orleans,159656,"Primarily online, some courses in person",https://faq.loyno.edu/return-campus,22071,3306,Primarily Online,716,4022
Reedley College,117052,"Primarily online, some courses in person",https://www.reedleycollege.edu/covid-19/index.html,06019,3319,Primarily Online,474,3793
Anoka-Ramsey Community College,172963,"Primarily online, some courses in person",http://www.anokaramsey.edu/about-us/safety-security/coronavirus-covid-19/,27003,3329,Primarily Online,375,3704
Bemidji State University,173124,"Primarily online, some courses in person",https://www.bemidjistate.edu/return-to-campus/,27007,3352,Primarily Online,467,3819
North Central Texas College,224110,"Primarily online, some courses in person",https://www.nctc.edu/coronavirus/index.html,48097,3363,Primarily Online,678,4041
SUNY College at Potsdam,196200,"Primarily online, some courses in person",https://www.potsdam.edu/about/potsdam-prepared,36089,3390,Primarily Online,701,4091
Clarion University of Pennsylvania,211644,"Primarily online, some courses in person",https://www.clarion.edu/student-life/health-fitness-and-wellness/health-care-services/trending-health-topics.html,42031,3409,Primarily Online,633,4042
New Mexico State University-Dona Ana,187620,"Primarily online, some courses in person",https://nmsu.edu/coronavirus/#communications,35013,3417,Primarily Online,455,3872
Century College,175315,"Primarily online, some courses in person",https://www.century.edu/coronavirus-disease-2019-covid-19-information,27163,3419,Primarily Online,457,3876
Bossier Parish Community College,158431,"Primarily online, some courses in person",https://www.bpcc.edu/index.php/coronavirus-information/,22015,3434,Primarily Online,375,3809
Pitt Community College,199333,"Primarily online, some courses in person",https://pittcc.edu/taskforce-working-to-minimize-coronavirus-risk-on-campus/,37147,3450,Primarily Online,669,4119
San Antonio College,227924,"Primarily online, some courses in person",https://www.alamo.edu/coronavirus/,48029,3453,Primarily Online,867,4320
Motlow State Community College,221096,"Primarily online, some courses in person",https://news.mscc.edu/coronavirus,47127,3455,Primarily Online,414,3869
Hartnell College,115393,"Primarily online, some courses in person",https://www.hartnell.edu/about/safety/emergency/coronavirus.html,06053,3493,Primarily Online,407,3900
County College of Morris,184180,"Primarily online, some courses in person",https://www.ccm.edu/covid-19-information-center/,34027,3505,Primarily Online,548,4053
Holmes Community College,175810,"Primarily online, some courses in person",https://www.holmescc.edu/administration/marketing/covid-19.aspx,28051,3527,Primarily Online,441,3968
Rockland Community College,195058,"Primarily online, some courses in person",http://www.sunyrockland.edu/about/coronavirus,36087,3542,Primarily Online,547,4089
Allan Hancock College,108807,"Primarily online, some courses in person",https://www.hancockcollege.edu/covid/,06083,3560,Primarily Online,605,4165
Spokane Falls Community College,236708,"Primarily online, some courses in person",https://sfcc.spokane.edu/News-Events/Coronavirus,53063,3561,Primarily Online,418,3979
Edmonds Community College,235103,"Primarily online, some courses in person",https://www.edcc.edu/safety/coronavirus-resources/default.html,53061,3577,Primarily Online,674,4251
Framingham State University,165866,"Primarily online, some courses in person",https://www.framingham.edu/about-fsu/news-and-events/covid-19-updates-resources-and-information.html1,25017,3580,Primarily Online,594,4174
Essex County College,184481,"Primarily online, some courses in person",https://www.essex.edu/coronavirusalert/,34013,3589,Primarily Online,552,4141
Bethune-Cookman University,132602,"Primarily online, some courses in person",http://www.cookman.edu/covid.html,12127,3608,Primarily Online,453,4061
Seattle Central College,236513,"Primarily online, some courses in person",https://newscenter.seattlecentral.edu/coronavirus-update,53033,3623,Primarily Online,675,4298
City Colleges of Chicago-Wilbur Wright College,144218,"Primarily online, some courses in person",https://prepare.ccc.edu/,17031,3638,Primarily Online,377,4015
Pearl River Community College,176239,"Primarily online, some courses in person",http://www.prcc.edu/news/pearl-river-plans-welcome-students-back-fall-plenty-options,28109,3640,Primarily Online,453,4093
Dutchess Community College,190840,"Primarily online, some courses in person",https://www.sunydutchess.edu/covid/index.html,36027,3666,Primarily Online,503,4169
Highline College,235431,"Primarily online, some courses in person",https://www.highline.edu/covid19/,53033,3673,Primarily Online,534,4207
Polk State College,136516,"Primarily online, some courses in person",https://www.polk.edu/campus-safety-security/covid-19/,12105,3675,Primarily Online,654,4329
Robert Morris University,215655,"Primarily online, some courses in person",https://www.rmu.edu/about/health,42003,3683,Primarily Online,633,4316
SUNY Empire State College,196264,"Primarily online, some courses in person",https://www.esc.edu/safety-security/covid19/,36091,3688,Primarily Online,858,4546
Golden West College,115126,"Primarily online, some courses in person",https://www.goldenwestcollege.edu/covid19/,06059,3699,Primarily Online,461,4160
Cosumnes River College,113096,"Primarily online, some courses in person",https://losrios.edu/coronavirus,06067,3749,Primarily Online,491,4240
Arizona State University-West,407009,"Primarily online, some courses in person",https://eoss.asu.edu/health/announcements/coronavirus,04013,3753,Primarily Online,752,4505
Pensacola State College,136473,"Primarily online, some courses in person",https://www.pensacolastate.edu/coronavirus-resources/,12033,3785,Primarily Online,687,4472
Saint Mary's University of Minnesota,174817,"Primarily online, some courses in person",https://www.smumn.edu/about/covid-19-planning,27169,3787,Primarily Online,617,4404
Tacoma Community College,236753,"Primarily online, some courses in person",https://www.tacomacc.edu/coronavirus,53053,3812,Primarily Online,643,4455
Chabot College,111920,"Primarily online, some courses in person",http://www.chabotcollege.edu/coronavirus/,06001,3837,Primarily Online,467,4304
Edinboro University of Pennsylvania,212160,"Primarily online, some courses in person",https://www.edinboro.edu/directory/offices-services/ehs/ready/coronavirus,42049,3840,Primarily Online,629,4469
Rowan College at Gloucester County,184791,"Primarily online, some courses in person",https://www.rcsj.edu/coronavirus,34015,3851,Primarily Online,462,4313
Baker College,168847,"Primarily online, some courses in person",https://www.baker.edu/coronavirus,26155,3852,Primarily Online,941,4793
SUNY at Purchase College,196219,"Primarily online, some courses in person",https://www.purchase.edu/covid-19-updates-and-plans/,36119,3858,Primarily Online,814,4672
Mississippi College,176053,"Primarily online, some courses in person",https://www.mc.edu/mcalert/coronavirus/,28049,3864,Primarily Online,589,4453
Columbia Basin College,234979,"Primarily online, some courses in person",https://www.columbiabasin.edu/index.aspx?page=2504,53021,3928,Primarily Online,436,4364
Northwest Vista College,420398,"Primarily online, some courses in person",https://www.alamo.edu/coronavirus/,48029,3929,Primarily Online,600,4529
Richland College,227766,"Primarily online, some courses in person",https://www.dcccd.edu/coronavirus/pages/default.aspx?utm_source=shortcut+url&utm_medium=redirect&utm_campaign=community&utm_term=coronavirus,48113,3944,Primarily Online,928,4872
San Bernardino Valley College,123527,"Primarily online, some courses in person",http://www.sbccd.org/Human_Resources-Jobs/employee-labor-relations/safetyrisk/Coronavirus_Updates,06071,3946,Primarily Online,629,4575
Northeastern Illinois University,147776,"Primarily online, some courses in person",https://www.neiu.edu/about/coronavirus-response,17031,3967,Primarily Online,1064,5031
Antelope Valley College,109350,"Primarily online, some courses in person",https://www.avc.edu/novel-coronavirus,06037,3989,Primarily Online,719,4708
Cabrillo College,110334,"Primarily online, some courses in person",http://www.cabrillo.edu/covid-19/,06087,4002,Primarily Online,585,4587
Frostburg State University,162584,"Primarily online, some courses in person",https://www.frostburg.edu/fall2020/index.php,24001,4010,Primarily Online,779,4789
Baton Rouge Community College,437103,"Primarily online, some courses in person",https://www.mybrcc.edu/coronavirus/index.php,22033,4020,Primarily Online,423,4443
Delaware State University,130934,"Primarily online, some courses in person",https://www.desu.edu/student-life/student-health-services/covid-19,10001,4020,Primarily Online,816,4836
Olympic College,236188,"Primarily online, some courses in person",https://www.olympic.edu/about-olympic-college/covid-19-coronavirus-information,53035,4024,Primarily Online,468,4492
University of Houston-Clear Lake,225414,"Primarily online, some courses in person",https://www.uhcl.edu/health-alert/,48201,4045,Primarily Online,856,4901
Lewis University,146612,"Primarily online, some courses in person",https://www.lewisu.edu/covid-19/index.htm,17197,4066,Primarily Online,731,4797
Henry Ford College,170240,"Primarily online, some courses in person",https://www.hfcc.edu/coronavirus,26163,4068,Primarily Online,659,4727
Chattanooga State Community College,219824,"Primarily online, some courses in person",https://www.chattanoogastate.edu/coronavirus-information-campus-community,47065,4072,Primarily Online,752,4824
Everett Community College,235149,"Primarily online, some courses in person",https://www.everettcc.edu/administration/cwt-security/security/emergency-management/resources/covid-19-novel-coronavirus,53061,4086,Primarily Online,601,4687
Imperial Valley College,115861,"Primarily online, some courses in person",https://www.imperial.edu/about/coronavirus/?from=square-homepage-graphic-left,06025,4102,Primarily Online,401,4503
Grand Rapids Community College,170055,"Primarily online, some courses in person",https://www.grcc.edu/coronavirusinformation,26081,4104,Primarily Online,810,4914
Normandale Community College,174428,"Primarily online, some courses in person",https://www.normandale.edu/coronavirus-information,27053,4108,Primarily Online,459,4567
Chandler-Gilbert Community College,364025,"Primarily online, some courses in person",https://www.maricopa.edu/coronavirus-covid-19,04013,4114,Primarily Online,583,4697
Oklahoma City Community College,207449,"Primarily online, some courses in person",http://www.occc.edu/coronavirus/,40109,4119,Primarily Online,534,4653
Georgia Military College,485111,"Primarily online, some courses in person",https://www.gmc.edu/current-students/coronavirus-info.cms,13009,4152,Primarily Online,756,4908
College of Lake County,146472,"Primarily online, some courses in person",https://www.clcillinois.edu/student-services/additional-services/health-center/preventative-action-against-coronavirus,17097,4164,Primarily Online,942,5106
Western Oregon University,210429,"Primarily online, some courses in person",https://wou.edu/coronavirus/,41053,4171,Primarily Online,787,4958
Pasco-Hernando State College,136400,"Primarily online, some courses in person",https://phsc.edu/about/news/announcement/phsc-monitors-coronavirus-update,12101,4207,Primarily Online,611,4818
University of Michigan-Flint,171146,"Primarily online, some courses in person",https://www.umflint.edu/blueprint,26049,4208,Primarily Online,868,5076
Park University,178721,"Primarily online, some courses in person",https://www.park.edu/coronavirus/,29165,4215,Primarily Online,857,5072
Camden County College,183938,"Primarily online, some courses in person",https://www.camdencc.edu/coronavirus/,34007,4271,Primarily Online,575,4846
Lansing Community College,170657,"Primarily online, some courses in person",https://www.lcc.edu/coronavirus/return-students.html#spring,26065,4321,Primarily Online,1100,5421
Central Texas College,223816,"Primarily online, some courses in person",http://www.ctcd.edu/covid-19-return-to-campus/,48099,4355,Primarily Online,1080,5435
Aurora University,143118,"Primarily online, some courses in person",https://aurora.edu/student-life/campus-services/wellness/coronavirus/index.html,17089,4367,Primarily Online,576,4943
Foothill College,114716,"Primarily online, some courses in person",https://foothill.edu/healthservices/corona-virus.html,06085,4372,Primarily Online,434,4806
Milwaukee Area Technical College,239248,"Primarily online, some courses in person",http://www.matc.edu/coronavirus/index.html,55079,4413,Primarily Online,1508,5921
Rowan College at Burlington County,183877,"Primarily online, some courses in person",https://www.rcbc.edu/resources,34005,4418,Primarily Online,586,5004
Ocean County College,185873,"Primarily online, some courses in person",https://www.ocean.edu/coronavirus/,34029,4427,Primarily Online,615,5042
Fayetteville State University,198543,"Primarily online, some courses in person",https://www.uncfsu.edu/coronavirus-update,37051,4456,Primarily Online,806,5262
University of Washington-Tacoma Campus,377564,"Primarily online, some courses in person",https://www.tacoma.uw.edu/chancellor/coronaviruscovid-19-facts-resources,53053,4472,Primarily Online,608,5080
Widener University,216852,"Primarily online, some courses in person",https://www.widener.edu/coronavirus,42045,4496,Primarily Online,1064,5560
Fayetteville Technical Community College,198534,"Primarily online, some courses in person",https://www.faytechcc.edu/ftcc-coronavirus-information/,37051,4509,Primarily Online,983,5492
Midwestern State University,226833,"Primarily online, some courses in person",https://msutexas.edu/coronavirus/index.php,48485,4520,Primarily Online,693,5213
William Rainey Harper College,149842,"Primarily online, some courses in person",https://www.harpercollege.edu/advisory/index.php,17031,4606,Primarily Online,984,5590
City Colleges of Chicago-Harold Washington College,144209,"Primarily online, some courses in person",https://prepare.ccc.edu/,17031,4610,Primarily Online,399,5009
Delaware Technical Community College-Terry,130907,"Primarily online, some courses in person",https://www.dtcc.edu/about/news-events/coronavirus-update,10001,4629,Primarily Online,1162,5791
Biola University,110097,"Primarily online, some courses in person",https://www.biola.edu/coronavirus,06037,4656,Primarily Online,1085,5741
Chemeketa Community College,208390,"Primarily online, some courses in person",https://www.chemeketa.edu/about/parking-public-safety/coronavirus/,41047,4659,Primarily Online,753,5412
University of Indianapolis,151263,"Primarily online, some courses in person",https://uindy.edu/coronavirus/,18097,4678,Primarily Online,898,5576
Joliet Junior College,146296,"Primarily online, some courses in person",https://www.jjc.edu/advisory-information-coronavirus,17197,4685,Primarily Online,898,5583
CUNY Medgar Evers College,190646,"Primarily online, some courses in person",https://ares.mec.cuny.edu/president-covid19-mediation-plan/student-resources/,36047,4705,Primarily Online,746,5451
University of Southern Maine,161554,"Primarily online, some courses in person",https://usm.maine.edu/healthy-huskies,23005,4707,Primarily Online,1236,5943
Pratt Institute-Main,194578,"Primarily online, some courses in person",https://www.pratt.edu/coronavirus/,36047,4730,Primarily Online,1145,5875
Southwest Tennessee Community College,221485,"Primarily online, some courses in person",http://www.southwest.tn.edu/coronavirus/,47157,4732,Primarily Online,788,5520
Merced College,118718,"Primarily online, some courses in person",http://www.mccd.edu/news/covid-19-update/index.html,06047,4743,Primarily Online,618,5361
Hudson County Community College,184995,"Primarily online, some courses in person",http://www.hccc.edu/Coronavirus-Resources/,34017,4754,Primarily Online,566,5320
Tulsa Community College,207935,"Primarily online, some courses in person",https://www.tulsacc.edu/campus-life/campus-safety/coronavirus,40143,4773,Primarily Online,1300,6073
Butte College,110246,"Primarily online, some courses in person",http://www.butte.edu/coronavirus/,06007,4798,Primarily Online,743,5541
Texas State Technical College,487320,"Primarily online, some courses in person",https://www.tstc.edu/coronavirus,48309,4853,Primarily Online,1562,6415
Bentley University,164739,"Primarily online, some courses in person",https://www.bentley.edu/coronavirus,25017,4879,Primarily Online,961,5840
Clark College,234933,"Primarily online, some courses in person",http://www.clark.edu/about/emergencies/coronavirus/index.php,53011,4907,Primarily Online,799,5706
Pikes Peak Community College,127820,"Primarily online, some courses in person",https://www.ppcc.edu/office-president/presidential-communication-2/coronavirus/fall-2020-plans,08041,4916,Primarily Online,760,5676
University of Washington-Bothell Campus,377555,"Primarily online, some courses in person",https://www.uwb.edu/coronavirus,53033,4916,Primarily Online,631,5547
University of Wisconsin-Green Bay,240277,"Primarily online, some courses in person",https://www.uwgb.edu/coronavirus/,55009,4961,Primarily Online,724,5685
Ramapo College of New Jersey,186201,"Primarily online, some courses in person",https://www.ramapo.edu/health/coronavirus-covid-19/,34003,4969,Primarily Online,787,5756
Pima Community College,105525,"Primarily online, some courses in person",https://www.pima.edu/news/coronavirus/index.html,04019,4977,Primarily Online,1640,6617
Front Range Community College,127200,"Primarily online, some courses in person",https://www.frontrange.edu/being-a-student/campus-safety/frcc-covid-19-updates,08001,4999,Primarily Online,983,5982
Middlesex County College,185536,"Primarily online, some courses in person",https://www.middlesexcc.edu/coronavirus/,34023,5044,Primarily Online,781,5825
Volunteer State Community College,222053,"Primarily online, some courses in person",https://www.volstate.edu/news/get-ready-fall-apply-now,47165,5055,Primarily Online,598,5653
MiraCosta College,118912,"Primarily online, some courses in person",http://www.miracosta.edu/officeofthepresident/pio/press.aspx?id=2958,06073,5062,Primarily Online,649,5711
College of the Sequoias,123217,"Primarily online, some courses in person",https://www.cos.edu/en-us/student-life/health-services/coronavirus,06107,5100,Primarily Online,603,5703
Nicholls State University,159966,"Primarily online, some courses in person",https://www.nicholls.edu/covid-19/campus-updates/,22057,5102,Primarily Online,680,5782
Pellissippi State Community College,221643,"Primarily online, some courses in person",http://www.pstcc.edu/coronavirus/index.php,47093,5111,Primarily Online,673,5784
CUNY York College,190691,"Primarily online, some courses in person",https://www.york.cuny.edu/news/coronavirus,36081,5232,Primarily Online,835,6067
Metropolitan Community College Area,181303,"Primarily online, some courses in person",https://mccneb.edu/coronavirus.aspx,31055,5263,Primarily Online,1150,6413
Brandeis University,165015,"Primarily online, some courses in person",https://www.brandeis.edu/coronavirus/,25017,5267,Primarily Online,1646,6913
Shippensburg University of Pennsylvania,216010,"Primarily online, some courses in person",http://www.ship.edu/coronavirus/,42041,5271,Primarily Online,802,6073
Santa Ana College,121619,"Primarily online, some courses in person",https://rsccd.edu/Coronavirus/Pages/default.aspx,06059,5283,Primarily Online,824,6107
Sacramento City College,122180,"Primarily online, some courses in person",https://scc.losrios.edu/campus-life/news/coronavirus-update,06067,5318,Primarily Online,748,6066
Eastern Florida State College,132693,"Primarily online, some courses in person",https://www.easternflorida.edu/admissions/registrars-office/registration-information/fall-live-online.cfm,12009,5320,Primarily Online,1043,6363
Green River College,235343,"Primarily online, some courses in person",https://www.greenriver.edu/campus/campus-safety/emergency-preparedness/covid19/,53033,5326,Primarily Online,620,5946
San Diego Mesa College,122375,"Primarily online, some courses in person",http://www.sdmesa.edu/student-services/health-services/index.shtml,06073,5348,Primarily Online,644,5992
Community College of Allegheny County,210605,"Primarily online, some courses in person",https://www.ccac.edu/security/coronavirus-covid-19.php,42003,5354,Primarily Online,1152,6506
Rhode Island College,217420,"Primarily online, some courses in person",,44007,5364,Primarily Online,985,6349
Daytona State College,133386,"Primarily online, some courses in person",http://www.daytonastate.edu/COVID-19/,12127,5366,Primarily Online,1049,6415
Rutgers University-Camden,186371,"Primarily online, some courses in person",https://coronavirus.rutgers.edu/,34007,5376,Primarily Online,1051,6427
University of Wisconsin-River Falls,240471,"Primarily online, some courses in person",https://www.uwrf.edu/COVID-19/,55093,5396,Primarily Online,637,6033
Campbell University,198136,"Primarily online, some courses in person",https://www.campbell.edu/coronavirus/,37085,5457,Primarily Online,1101,6558
Glendale Community College,104708,"Primarily online, some courses in person",https://www.maricopa.edu/coronavirus-covid-19,04013,5464,Primarily Online,930,6394
Mt San Jacinto Community College District,119216,"Primarily online, some courses in person",https://www.msjc.edu/coronavirus/,06065,5496,Primarily Online,845,6341
Saddleback College,122205,"Primarily online, some courses in person",https://www.saddleback.edu/HealthandSafetyUpdates,06059,5531,Primarily Online,805,6336
Brookdale Community College,183859,"Primarily online, some courses in person",https://www.brookdalecc.edu/advancement/college-relations/brookdales-response-to-covid-19/,34025,5535,Primarily Online,670,6205
East Stroudsburg University of Pennsylvania,212115,"Primarily online, some courses in person",https://www.esu.edu/open/index.cfm,42089,5550,Primarily Online,657,6207
Johnson County Community College,155210,"Primarily online, some courses in person",https://www.jccc.edu/media-resources/covid-19/,20091,5551,Primarily Online,1368,6919
Jackson State University,175856,"Primarily online, some courses in person",https://www.jsums.edu/covid19/,28049,5578,Primarily Online,1065,6643
Moorpark College,119137,"Primarily online, some courses in person",https://www.vcccd.edu/news/vcccd-alerts,06111,5593,Primarily Online,463,6056
Moraine Valley Community College,147378,"Primarily online, some courses in person",https://www.morainevalley.edu/news/,17031,5607,Primarily Online,814,6421
Hudson Valley Community College,191719,"Primarily online, some courses in person",https://www.hvcc.edu/covid19/index.html,36083,5636,Primarily Online,692,6328
Jacksonville State University,101480,"Primarily online, some courses in person",http://www.jsu.edu/coronavirus/index.html,01015,5707,Primarily Online,1031,6738
Delgado Community College,158662,"Primarily online, some courses in person",http://www.dcc.edu/coronavirus/default.aspx,22071,5733,Primarily Online,898,6631
University of Michigan-Dearborn,171137,"Primarily online, some courses in person",https://umdearborn.edu/offices/external-relations/key-issues/um-dearborn-covid-19-response,26163,5740,Primarily Online,947,6687
Community College of Rhode Island,217475,"Primarily online, some courses in person",,44003,5756,Primarily Online,938,6694
Seminole State College of Florida,137209,"Primarily online, some courses in person",https://www.seminolestate.edu/security/cdp/coronavirus,12117,5773,Primarily Online,1013,6786
Millersville University of Pennsylvania,214041,"Primarily online, some courses in person",https://www.millersville.edu/fall2020/,42071,5786,Primarily Online,899,6685
Seattle University,236595,"Primarily online, some courses in person",https://www.seattleu.edu/coronavirus/,53033,5904,Primarily Online,1468,7372
University of Louisiana at Monroe,159993,"Primarily online, some courses in person",https://www.ulm.edu/coronavirus/,22073,5969,Primarily Online,867,6836
Macomb Community College,170790,"Primarily online, some courses in person",https://www.macomb.edu/about-macomb/coronavirus/index.html,26099,5975,Primarily Online,1054,7029
Suffolk University,168005,"Primarily online, some courses in person",https://www.suffolk.edu/student-life/health-wellness/coronavirus-health-advisory,25025,5975,Primarily Online,1097,7072
Santa Rosa Junior College,123013,"Primarily online, some courses in person",https://www.santarosa.edu/coronavirus-information,06097,6000,Primarily Online,1077,7077
College of the Canyons,111461,"Primarily online, some courses in person",https://www.canyons.edu/administration/pio/notices/index.php,06037,6075,Primarily Online,836,6911
Lehigh University,213543,"Primarily online, some courses in person",https://coronavirus.lehigh.edu/,42095,6093,Primarily Online,1800,7893
New York Institute of Technology,194091,"Primarily online, some courses in person",https://www.nyit.edu/about/reopening,36059,6118,Primarily Online,1360,7478
SUNY Westchester Community College,197294,"Primarily online, some courses in person",https://www.sunywcc.edu/about/updates-from-the-college/,36119,6156,Primarily Online,839,6995
California State University-Channel Islands,441937,"Primarily online, some courses in person",https://www.csuci.edu/news/campus-updates/covid19.htm,06111,6160,Primarily Online,836,6996
Grossmont College,115296,"Primarily online, some courses in person",https://www.grossmont.edu/covid19/,06073,6162,Primarily Online,738,6900
Mesa Community College,105154,"Primarily online, some courses in person",https://www.mesacc.edu/coronavirus,04013,6171,Primarily Online,1049,7220
American River College,109208,"Primarily online, some courses in person",https://arc.losrios.edu/campus-life/news/coronavirus-update,06067,6173,Primarily Online,958,7131
Riverside City College,121901,"Primarily online, some courses in person",https://www.rccd.edu/admin/bfs/risk/Pages/covid_19.aspx,06065,6210,Primarily Online,749,6959
University of the Incarnate Word,225627,"Primarily online, some courses in person",https://my.uiw.edu/safety/coronavirus.html,48029,6214,Primarily Online,1307,7521
Columbia College Chicago,144281,"Primarily online, some courses in person",https://www.colum.edu/reopening/campus-messages,17031,6279,Primarily Online,996,7275
San Joaquin Delta College,122658,"Primarily online, some courses in person",https://www.deltacollege.edu/coronavirus,06077,6296,Primarily Online,703,6999
University of Houston-Downtown,225432,"Primarily online, some courses in person",https://www.uhd.edu/administration/emergency-management/coronavirus/Pages/default.aspx,48201,6332,Primarily Online,1108,7440
Central New Mexico Community College,187532,"Primarily online, some courses in person",https://return.cnm.edu/,35001,6345,Primarily Online,1458,7803
Santa Barbara City College,122889,"Primarily online, some courses in person",http://www.sbcc.edu/newsandevents/covid-19/,06083,6354,Primarily Online,1041,7395
Chaffey College,111939,"Primarily online, some courses in person",https://www.chaffey.edu/coronavirus/index.php,06071,6370,Primarily Online,900,7270
SUNY Cortland,196149,"Primarily online, some courses in person",http://www2.cortland.edu/about/restart/,36023,6391,Primarily Online,1103,7494
University of Missouri-St Louis,178420,"Primarily online, some courses in person",https://www.umsl.edu/hcdas/coronaupdates.html,29189,6401,Primarily Online,1562,7963
Des Moines Area Community College,153214,"Primarily online, some courses in person",https://www.dmacc.edu/coronavirus/Pages/welcome.aspx,19153,6430,Primarily Online,1131,7561
University of Wisconsin-Stout,240417,"Primarily online, some courses in person",https://www.uwstout.edu/covid-19-coronavirus-planning-and-preparedness,55033,6432,Primarily Online,1018,7450
Dartmouth College,182670,"Primarily online, some courses in person",https://news.dartmouth.edu/covid-19/academic-year-2020-21-return-campus-plan,33009,6436,Primarily Online,3812,10248
California State University-Monterey Bay,409698,"Primarily online, some courses in person",https://csumb.edu/health/coronavirus-information,06053,6457,Primarily Online,870,7327
Winona State University,175272,"Primarily online, some courses in person",https://www.winona.edu/emergency/health-alert.asp,27169,6457,Primarily Online,784,7241
Adelphi University,188429,"Primarily online, some courses in person",https://www.adelphi.edu/covid-19/,36059,6562,Primarily Online,1448,8010
Cerritos College,111887,"Primarily online, some courses in person",https://www.cerritos.edu/shs/covid-19.htm,06037,6566,Primarily Online,847,7413
Saint Louis Community College,179308,"Primarily online, some courses in person",https://stlcc.edu/messages/covid-19.aspx,29189,6580,Primarily Online,1553,8133
State University of New York at New Paltz,196176,"Primarily online, some courses in person",https://www.newpaltz.edu/coronavirus-info/,36111,6639,Primarily Online,1120,7759
University of Alaska Anchorage,102553,"Primarily online, some courses in person",https://sites.google.com/alaska.edu/coronavirus/uaa?authuser=0,02020,6645,Primarily Online,1667,8312
Erie Community College,191083,"Primarily online, some courses in person",https://www.ecc.edu/Coronavirus-Information/,36029,6706,Primarily Online,1136,7842
Central Piedmont Community College,198260,"Primarily online, some courses in person",https://www.cpcc.edu/about-central-piedmont/administrative-offices/college-security-services/emergency-management/coronavirus,37119,6781,Primarily Online,1735,8516
Johnson & Wales University-Providence,217235,"Primarily online, some courses in person",https://covid.jwu.edu/?_ga=2.35082472.85728332.1594568117-304252568.1594568117,44007,6787,Primarily Online,1077,7864
Columbus State Community College,202222,"Primarily online, some courses in person",https://www.cscc.edu/about/coronavirus/,39049,6825,Primarily Online,1562,8387
The College of New Jersey,187134,"Primarily online, some courses in person",https://health.tcnj.edu/2020/02/07/coronavirus-information/,34021,6993,Primarily Online,1359,8352
Southwestern College,123800,"Primarily online, some courses in person",https://www.swccd.edu/student-support/health-services/special-health-updates/index.aspx,06073,7004,Primarily Online,880,7884
University of Wisconsin-Platteville,240462,"Primarily online, some courses in person",https://www.uwplatt.edu/news/update-coronavirus,55043,7009,Primarily Online,980,7989
Southern Utah University,230603,"Primarily online, some courses in person",https://www.suu.edu/coronavirus/,49021,7034,Primarily Online,1012,8046
Bergen Community College,183743,"Primarily online, some courses in person",https://bergen.edu/covid19/,34003,7320,Primarily Online,851,8171
San Jacinto Community College,227979,"Primarily online, some courses in person",https://www.sanjac.edu/coronavirus,48201,7348,Primarily Online,1819,9167
University of San Diego,122436,"Primarily online, some courses in person",https://www.sandiego.edu/coronavirus/,06073,7349,Primarily Online,2037,9386
Bakersfield College,109819,"Primarily online, some courses in person",https://www.bakersfieldcollege.edu/covid19,06029,7351,Primarily Online,814,8165
Florida State College at Jacksonville,133702,"Primarily online, some courses in person",https://www.fscj.edu/covid-19,12031,7351,Primarily Online,1603,8954
Tidewater Community College,233772,"Primarily online, some courses in person",https://www.tcc.edu/about-tcc/safety-security/emergency-preparedness/covid-19-tccs-response-and-resources-for-faculty-staff-and-students/,51710,7375,Primarily Online,1135,8510
Fashion Institute of Technology,191126,"Primarily online, some courses in person",http://www.fitnyc.edu/emergency/coronavirus/index.php,36061,7406,Primarily Online,1147,8553
Diablo Valley College,113634,"Primarily online, some courses in person",https://www.dvc.edu/about/safety/health-advisories/index.html,06013,7440,Primarily Online,725,8165
Monroe Community College,193326,"Primarily online, some courses in person",https://www.monroecc.edu/coronavirus/,36055,7483,Primarily Online,1101,8584
Touro College,196592,"Primarily online, some courses in person",https://www.touro.edu/updates/coronavirus/,36061,7485,Primarily Online,1823,9308
Salt Lake Community College,230746,"Primarily online, some courses in person",http://www.slcc.edu/policies/policies/presidents_office/7.1.001.aspx,49035,7496,Primarily Online,1982,9478
University of Wisconsin-Stevens Point,240480,"Primarily online, some courses in person",https://www.uwsp.edu/coronavirus/Pages/default.aspx,55097,7512,Primarily Online,1069,8581
Santa Clara University,122931,"Primarily online, some courses in person",https://www.scu.edu/preparedscu/covid-19/,06085,7569,Primarily Online,1628,9197
Slippery Rock University of Pennsylvania,216038,"Primarily online, some courses in person",https://www.sru.edu/covid19/index.html,42019,7587,Primarily Online,941,8528
Wake Technical Community College,199856,"Primarily online, some courses in person",https://www.waketech.edu/about-wake-tech/learn-well,37183,7611,Primarily Online,1692,9303
Southern Connecticut State University,130493,"Primarily online, some courses in person",https://inside.southernct.edu/announcement/fall-course-delivery-format-change,09009,7616,Primarily Online,1220,8836
Palomar College,120971,"Primarily online, some courses in person",https://www2.palomar.edu/pages/covid19/,06073,7682,Primarily Online,1051,8733
SUNY Buffalo State,196130,"Primarily online, some courses in person",https://coronavirus.buffalostate.edu/restart,36029,7694,Primarily Online,1393,9087
Fresno City College,114789,"Primarily online, some courses in person",https://www.fresnocitycollege.edu/covid-19/index.html,06019,7719,Primarily Online,952,8671
El Camino Community College District,113980,"Primarily online, some courses in person",https://www.elcamino.edu/notices/coronavirus/,06037,7782,Primarily Online,1037,8819
Rensselaer Polytechnic Institute,194824,"Primarily online, some courses in person",https://covid19.rpi.edu,36083,7798,Primarily Online,1786,9584
Orange Coast College,120342,"Primarily online, some courses in person",http://www.orangecoastcollege.edu/c/covid19/Pages/home.aspx,06059,7806,Primarily Online,836,8642
College of DuPage,144865,"Primarily online, some courses in person",https://www.cod.edu/coronavirus/index.aspx,17043,7857,Primarily Online,1411,9268
Wake Forest University,199847,"Primarily online, some courses in person",https://ourwayforward.wfu.edu/,37067,7880,Primarily Online,6945,14825
The University of Montana,180489,"Primarily online, some courses in person",https://www.umt.edu/coronavirus/default.php?utm_source=um_homepage,30063,7968,Primarily Online,1966,9934
CUNY Lehman College,190637,"Primarily online, some courses in person",http://www.lehman.edu/coronavirus/index.php,36005,8008,Primarily Online,1343,9351
City College of San Francisco,112190,"Primarily online, some courses in person",https://www.ccsf.edu/en/community.html,06075,8088,Primarily Online,1456,9544
Palm Beach State College,136358,"Primarily online, some courses in person",https://www.palmbeachstate.edu/safety/covid-19/default.aspx,12099,8112,Primarily Online,1644,9756
CUNY Kingsborough Community College,190619,"Primarily online, some courses in person",http://www.kbcc.cuny.edu/distancelearning/corona_info.html,36047,8154,Primarily Online,1287,9441
Central Connecticut State University,128771,"Primarily online, some courses in person",https://www.ccsu.edu/coronavirus/,09003,8167,Primarily Online,1181,9348
Sonoma State University,123572,"Primarily online, some courses in person",http://covid19.sonoma.edu/,06097,8292,Primarily Online,1124,9416
Bridgewater State University,165024,"Primarily online, some courses in person",https://www.bridgew.edu/covid-19,25023,8344,Primarily Online,1276,9620
California Baptist University,110361,"Primarily online, some courses in person",https://calbaptist.edu/,06065,8360,Primarily Online,1100,9460
Saint Cloud State University,174783,"Primarily online, some courses in person",https://www.stcloudstate.edu/emergency/covid19/bring-huskies-home/default.aspx,27145,8512,Primarily Online,1071,9583
University of Denver,127060,"Primarily online, some courses in person",https://www.du.edu/coronavirus,08031,8528,Primarily Online,2754,11282
University of Central Arkansas,106704,"Primarily online, some courses in person",https://uca.edu/coronavirus/,05045,8642,Primarily Online,1537,10179
California State University-Stanislaus,110495,"Primarily online, some courses in person",https://www.csustan.edu/covid-19,06099,8737,Primarily Online,1033,9770
Loyola Marymount University,117946,"Primarily online, some courses in person",,06037,8750,Primarily Online,2146,10896
Long Beach City College,117645,"Primarily online, some courses in person",https://www.lbcc.edu/coronavirus,06037,8754,Primarily Online,1101,9855
St Petersburg College,137078,"Primarily online, some courses in person",https://www.spcollege.edu/spc-updates,12103,8758,Primarily Online,1795,10553
El Paso Community College,224642,"Primarily online, some courses in person",https://www.epcc.edu/Media/Lists/News/Article.aspx?ID=187,48141,8824,Primarily Online,1718,10542
California State University-Bakersfield,110486,"Primarily online, some courses in person",https://www.csub.edu/covid-19,06029,8914,Primarily Online,1032,9946
Austin Community College District,222992,"Primarily online, some courses in person",https://www.austincc.edu/coronavirus,48453,8983,Primarily Online,2729,11712
De Anza College,113333,"Primarily online, some courses in person",https://www.deanza.edu/healthservices/covid19.html,06085,9210,Primarily Online,665,9875
University of Wisconsin-Oshkosh,240365,"Primarily online, some courses in person",https://uwosh.edu/coronavirus/,55139,9374,Primarily Online,1280,10654
Campbellsville University,156365,"Primarily online, some courses in person",https://www.campbellsville.edu/coronavirus-faq/,21217,9439,Primarily Online,809,10248
University of Missouri-Kansas City,178402,"Primarily online, some courses in person",https://www.umkc.edu/news/coronavirus.html,29095,9526,Primarily Online,2635,12161
University of Wisconsin-La Crosse,240329,"Primarily online, some courses in person",https://www.uwlax.edu/info/covid-19/,55063,9548,Primarily Online,1213,10761
Marshall University,237525,"Primarily online, some courses in person",https://www.marshall.edu/coronavirus/,54011,9588,Primarily Online,1848,11436
Rutgers University-Newark,186399,"Primarily online, some courses in person",https://coronavirus.rutgers.edu/,34013,9591,Primarily Online,1778,11369
Youngstown State University,206695,"Primarily online, some courses in person",https://ysu.edu/coronavirus-information,39099,9687,Primarily Online,1273,10960
Wright State University-Main Campus,206604,"Primarily online, some courses in person",https://www.google.com/url?client=internal-element-cse&cx=000584978819867948571:zmuthwrlpxm&q=https://www.wright.edu/coronavirus&sa=U&ved=2ahUKEwjrrr-6j8zqAhX9kHIEHTeUDLYQFjABegQIAhAB&usg=AOvVaw0iXHMXxCNPWlKa5Y_ph_3c,39057,9765,Primarily Online,1812,11577
University of San Francisco,122612,"Primarily online, some courses in person",https://myusf.usfca.edu/emergency-resources-campus-protocols/coronavirus-updates-resources,06075,9788,Primarily Online,1671,11459
College of Staten Island CUNY,190558,"Primarily online, some courses in person",https://www.csi.cuny.edu/about-csi/president-leadership/office-president/presidential-communications/coronavirus-message,36085,9793,Primarily Online,1327,11120
Wichita State University,156125,"Primarily online, some courses in person",https://www.wichita.edu/about/COVID-19/index.php,20173,10055,Primarily Online,2236,12291
Nassau Community College,193478,"Primarily online, some courses in person",https://www.ncc.edu/campusservices/health_services/covid.shtml,36059,10100,Primarily Online,1370,11470
Mt San Antonio College,119164,"Primarily online, some courses in person",https://www.mtsac.edu/health/,06037,10238,Primarily Online,1387,11625
Southern Illinois University-Edwardsville,149231,"Primarily online, some courses in person",https://www.siue.edu/about/announcements/coronavirus/,17119,10253,Primarily Online,2240,12493
Pace University,194310,"Primarily online, some courses in person",https://www.pace.edu/return-to-campus,36061,10287,Primarily Online,2115,12402
Southern Illinois University-Carbondale,149222,"Primarily online, some courses in person",https://siu.edu/coronavirus/,17077,10386,Primarily Online,4458,14844
Pasadena City College,121044,"Primarily online, some courses in person",https://pasadena.edu/about/president/coronavirus-updates/index.php,06037,10416,Primarily Online,1090,11506
University of Wisconsin-Whitewater,240189,"Primarily online, some courses in person",https://www.uww.edu/uhcs/covid19,55127,10603,Primarily Online,1250,11853
Hillsborough Community College,134495,"Primarily online, some courses in person",https://www.hccfl.edu/support-services/public-safety/coronavirus-updates,12057,10623,Primarily Online,1403,12026
Case Western Reserve University,201645,"Primarily online, some courses in person",https://case.edu/studentlife/healthcounseling/health-serviceshealth-updates/covid-19-campus-communications,39035,10662,Primarily Online,4456,15118
CUNY LaGuardia Community College,190628,"Primarily online, some courses in person",https://www.laguardia.edu/coronavirus/,36081,10671,Primarily Online,1594,12265
University of Maryland-Baltimore County,163268,"Primarily online, some courses in person",https://covid19.umbc.edu/,24005,10828,Primarily Online,2109,12937
Eastern Washington University,235097,"Primarily online, some courses in person",https://www.ewu.edu/coronavirus/,53063,10885,Primarily Online,1423,12308
CUNY New York City College of Technology,190655,"Primarily online, some courses in person",http://www.citytech.cuny.edu/financial-aid/excelsior_scholarship.aspx,36047,10902,Primarily Online,1429,12331
CUNY City College,190567,"Primarily online, some courses in person",https://www.ccny.cuny.edu/presidentsoffice/blog/covid-19,36061,10988,Primarily Online,1972,12960
CUNY John Jay College of Criminal Justice,190600,"Primarily online, some courses in person",https://johnjay.jjay.cuny.edu/coronavirus-updates/,36061,11128,Primarily Online,1504,12632
Cleveland State University,202134,"Primarily online, some courses in person",https://www.csuohio.edu/coronavirus-update/coronavirus-update,39035,11268,Primarily Online,1833,13101
Massachusetts Institute of Technology,166683,"Primarily online, some courses in person",https://covid19.mit.edu/,25017,11402,Primarily Online,13263,24665
East Tennessee State University,220075,"Primarily online, some courses in person",https://www.etsu.edu/coronavirus/,47179,11515,Primarily Online,2540,14055
CUNY Brooklyn College,190549,"Primarily online, some courses in person",http://www.brooklyn.cuny.edu/web/about/offices/studentaffairs/health-wellness/coronavirus.php,36047,11737,Primarily Online,1734,13471
Broward College,132709,"Primarily online, some courses in person",https://www.broward.edu/coronavirus/index.html,12011,11749,Primarily Online,1895,13644
California State University-East Bay,110574,"Primarily online, some courses in person",https://www.csueastbay.edu/coronavirus-information/index.html,06001,11886,Primarily Online,1404,13290
University of Massachusetts-Lowell,166513,"Primarily online, some courses in person",https://www.uml.edu/alert/coronavirus/,25017,11913,Primarily Online,1959,13872
CUNY Bernard M Baruch College,190512,"Primarily online, some courses in person",https://www.baruch.cuny.edu/coronavirus/,36061,12061,Primarily Online,1628,13689
California State University-Dominguez Hills,110547,"Primarily online, some courses in person",https://www.csudh.edu/alert/,06037,12183,Primarily Online,1339,13522
University of South Alabama,102094,"Primarily online, some courses in person",https://www.southalabama.edu/coronavirus/,01097,12323,Primarily Online,2276,14599
California State University-San Marcos,366711,"Primarily online, some courses in person",https://www.csusm.edu/incident/,06073,12656,Primarily Online,1364,14020
Emory University,139658,"Primarily online, some courses in person",https://www.emory.edu/forward/,13089,12902,Primarily Online,11842,24744
University of North Carolina Wilmington,199218,"Primarily online, some courses in person",https://uncw.edu/coronavirus/,37129,13075,Primarily Online,2183,15258
Carnegie Mellon University,211440,"Primarily online, some courses in person",https://www.cmu.edu/coronavirus/index.html,42003,13160,Primarily Online,5509,18669
University of Colorado Denver/Anschutz Medical Campus,126562,"Primarily online, some courses in person",https://www.ucdenver.edu/coronavirus/updates,08001,13182,Primarily Online,12132,25314
Suffolk County Community College,366395,"Primarily online, some courses in person",https://www.sunysuffolk.edu/coronavirus/,36103,13187,Primarily Online,1469,14656
Western Kentucky University,157951,"Primarily online, some courses in person",https://www.wku.edu/covid19/,21227,13228,Primarily Online,2102,15330
Yale University,130794,"Primarily online, some courses in person",https://covid19.yale.edu/,09009,13303,Primarily Online,15412,28715
University of Hawaii at Manoa,141574,"Primarily online, some courses in person",https://manoa.hawaii.edu/covid19/,15003,13329,Primarily Online,4102,17431
University of North Georgia,482680,"Primarily online, some courses in person",https://ung.edu/covid-19/,13187,13419,Primarily Online,1916,15335
Washington University in St Louis,179867,"Primarily online, some courses in person",https://covid19.wustl.edu/,29189,13773,Primarily Online,15922,29695
University of New Hampshire-Main Campus,183044,"Primarily online, some courses in person",https://www.unh.edu/coronavirus,33017,13896,Primarily Online,3027,16923
Tarrant County College District,228547,"Primarily online, some courses in person",https://www.tccd.edu/info-ribbon/coronavirus/,48439,13979,Primarily Online,2930,16909
University of Alabama at Birmingham,100663,"Primarily online, some courses in person",https://www.uab.edu/coronavirus/reentry,01073,14220,Primarily Online,9310,23530
University of Akron Main Campus,200800,"Primarily online, some courses in person",https://www.uakron.edu/return-to-campus/,39153,14245,Primarily Online,2188,16433
Oakland University,171571,"Primarily online, some courses in person",https://www.oakland.edu/reopening-campus/,26125,14605,Primarily Online,2030,16635
Western Washington University,237011,"Primarily online, some courses in person",https://www.wwu.edu/coronavirus,53073,14619,Primarily Online,1915,16534
CUNY Hunter College,190594,"Primarily online, some courses in person",https://hunter.cuny.edu/coronavirus/,36061,14635,Primarily Online,2380,17015
The University of Texas at El Paso,228796,"Primarily online, some courses in person",https://www.utep.edu/ehs/COVID-19/index.html,48141,15431,Primarily Online,2605,18036
Binghamton University,196079,"Primarily online, some courses in person",https://www.binghamton.edu/restarting-binghamton/?ref=homepage,36007,15748,Primarily Online,2447,18195
University of North Carolina at Greensboro,199148,"Primarily online, some courses in person",https://update.uncg.edu/,37081,15839,Primarily Online,2811,18650
University of Louisville,157289,"Primarily online, some courses in person",https://louisville.edu/coronavirus,21111,15936,Primarily Online,6422,22358
Valencia College,138187,"Primarily online, some courses in person",https://valenciacollege.edu/about/roadmap-for-reopening/,12095,16101,Primarily Online,2731,18832
Stanford University,243744,"Primarily online, some courses in person",https://healthalerts.stanford.edu/covid-19/,06085,16332,Primarily Online,15908,32240
Montclair State University,185590,"Primarily online, some courses in person",https://www.montclair.edu/university-health-center/coronavirus/?utm_source=octet&utm_campaign=homepage_coronavirus&utm_medium=montclair.edu&utm_content=1,34031,16547,Primarily Online,2431,18978
Northern Virginia Community College,232946,"Primarily online, some courses in person",https://www.nvcc.edu/safe-campus/index.html,51059,16709,Primarily Online,2318,19027
Houston Community College,225423,"Primarily online, some courses in person",https://www.hccs.edu/resources-for/current-students/communicable-diseases/,48201,16718,Primarily Online,3467,20185
Portland State University,209807,"Primarily online, some courses in person",https://www.pdx.edu/flexible-fall-psu,41051,16776,Primarily Online,2651,19427
California State University-San Bernardino,110510,"Primarily online, some courses in person",https://www.csusb.edu/covid-19,06071,17175,Primarily Online,1759,18934
Appalachian State University,197869,"Primarily online, some courses in person",https://www.appstate.edu/go/coronavirus/,37189,17291,Primarily Online,3036,20327
Northwestern University,147767,"Primarily online, some courses in person",https://www.northwestern.edu/coronavirus-covid-19-updates/,17031,17748,Primarily Online,10320,28068
CUNY Borough of Manhattan Community College,190521,"Primarily online, some courses in person",https://www.bmcc.cuny.edu/reimagining-bmcc/,36061,18076,Primarily Online,2009,20085
Brigham Young University-Idaho,142522,"Primarily online, some courses in person",https://www.byui.edu/covid-19-updates,16065,18335,Primarily Online,2098,20433
Florida Atlantic University,133669,"Primarily online, some courses in person",https://www.fau.edu/coronavirus/,12099,18562,Primarily Online,3281,21843
Wayne State University,172644,"Primarily online, some courses in person",https://wayne.edu/coronavirus/,26163,18746,Primarily Online,5518,24264
University of California-Santa Cruz,110714,"Primarily online, some courses in person",https://www.ucsc.edu/coronavirus/,06087,19093,Primarily Online,3567,22660
Utah Valley University,230737,"Primarily online, some courses in person",https://www.uvu.info/,49049,19451,Primarily Online,2748,22199
Ohio University-Main Campus,204857,"Primarily online, some courses in person",https://www.ohio.edu/coronavirus?utm_source=homepage&utm_medium=covidBanner&utm_campaign=featContentMarquee,39009,20184,Primarily Online,3828,24012
University of Oregon,209551,"Primarily online, some courses in person",https://www.uoregon.edu/coronavirus,41039,20703,Primarily Online,4828,25531
California Polytechnic State University-San Luis Obispo,110422,"Primarily online, some courses in person",https://coronavirus.calpoly.edu/,06079,20996,Primarily Online,2567,23563
California State University-Fresno,110556,"Primarily online, some courses in person",http://www.fresnostate.edu/president/coronavirus/index.html,06019,21444,Primarily Online,2095,23539
University of Nevada-Las Vegas,182281,"Primarily online, some courses in person",https://www.unlv.edu/coronavirus,32003,21541,Primarily Online,4467,26008
University of Delaware,130943,"Primarily online, some courses in person",https://www.udel.edu/home/coronavirus/,10003,21698,Primarily Online,4883,26581
Kent State University at Kent,203517,"Primarily online, some courses in person",https://www.kent.edu/coronavirus,39133,21700,Primarily Online,3602,25302
Stony Brook University,196097,"Primarily online, some courses in person",https://www.stonybrook.edu/comingback/,36103,21706,Primarily Online,4605,26311
Oregon State University,209542,"Primarily online, some courses in person",https://covid.oregonstate.edu/,41003,22133,Primarily Online,5639,27772
University of Arkansas,106397,"Primarily online, some courses in person",https://health.uark.edu/coronavirus/,05143,22602,Primarily Online,5184,27786
University of California-Riverside,110671,"Primarily online, some courses in person",https://ehs.ucr.edu/coronavirus,06065,23302,Primarily Online,4274,27576
University of Connecticut,129020,"Primarily online, some courses in person",https://uconn.edu/public-notification/coronavirus/,09013,24181,Primarily Online,8323,32504
San Francisco State University,122597,"Primarily online, some courses in person",https://news.sfsu.edu/covid-19,06075,24186,Primarily Online,2700,26886
University of Massachusetts-Amherst,166629,"Primarily online, some courses in person",https://www.umass.edu/coronavirus/,25015,24343,Primarily Online,6274,30617
University of Utah,230764,"Primarily online, some courses in person",https://coronavirus.utah.edu/,49035,24865,Primarily Online,13546,38411
University of Missouri-Columbia,178396,"Primarily online, some courses in person",https://mualert.missouri.edu/coronavirus/,29019,25265,Primarily Online,9192,34457
University of California-Santa Barbara,110705,"Primarily online, some courses in person",https://www.ucsb.edu/COVID-19-information,06083,25320,Primarily Online,4862,30182
California State University-Sacramento,110617,"Primarily online, some courses in person",https://www.csus.edu/alert/coronavirus.html,06067,25467,Primarily Online,2601,28068
University of Kentucky,157085,"Primarily online, some courses in person",https://www.uky.edu/coronavirus/,21067,26158,Primarily Online,11267,37425
Washington State University,236939,"Primarily online, some courses in person",https://wsu.edu/covid-19/,53075,26683,Primarily Online,6181,32864
Louisiana State University and Agricultural & Mechanical College,159391,"Primarily online, some courses in person",https://www.lsu.edu/coronavirus/index.php,22033,26862,Primarily Online,6385,33247
University of Illinois at Chicago,145600,"Primarily online, some courses in person",https://today.uic.edu/tag/coronavirus,17031,27117,Primarily Online,11825,38942
San Jose State University,122755,"Primarily online, some courses in person",https://www.sjsu.edu/healthadvisories/current-update/index.php,06085,27261,Primarily Online,2760,30021
California State University-Long Beach,110583,"Primarily online, some courses in person",https://www.csulb.edu/onebeach/reuniting-the-beach,06037,31079,Primarily Online,3166,34245
California State University-Northridge,110608,"Primarily online, some courses in person",https://www.csun.edu/COVID-19,06037,31524,Primarily Online,2995,34519
University of Houston,225511,"Primarily online, some courses in person",https://uh.edu/covid-19/,48201,33608,Primarily Online,5398,39006
Florida International University,133951,"Primarily online, some courses in person",https://www.fiu.edu/coronavirus/?utm_source=mainpage&utm_medium=banner&utm_campaign=yellow-banner#1,12086,34686,Primarily Online,5786,40472
Florida State University,134097,"Primarily online, some courses in person",https://news.fsu.edu/tag/coronavirus/,12073,34735,Primarily Online,7037,41772
University of California-Irvine,110653,"Primarily online, some courses in person",https://uci.edu/coronavirus/,06059,35200,Primarily Online,8450,43650
University of California-San Diego,110680,"Primarily online, some courses in person",https://vcsa.ucsd.edu/news/covid-19/,06073,36590,Primarily Online,15450,52040
Indiana University-Bloomington,151351,"Primarily online, some courses in person",https://fall2020.iu.edu/news/,18105,38311,Primarily Online,9113,47424
University of Washington-Seattle Campus,236948,"Primarily online, some courses in person",https://www.washington.edu/coronavirus/?utm_source=uwhp&utm_medium=tiles&utm_campaign=covid-safe-start,53033,41872,Primarily Online,18307,60179
Rutgers University-New Brunswick,186380,"Primarily online, some courses in person",https://newbrunswick.rutgers.edu/2020status,34023,42753,Primarily Online,18225,60978
University of California-Los Angeles,110662,"Primarily online, some courses in person",https://covid-19.ucla.edu/?_ga=2.23569594.1082668977.1594531910-1128821949.1594531910,06037,42895,Primarily Online,24010,66905
University of Florida,134130,"Primarily online, some courses in person",https://coronavirus.ufl.edu/,12001,44135,Primarily Online,15313,59448
Mid-South Christian College,481225,"Primarily online, with delayed transition to in-person instruction",https://www.midsouthchristian.edu/,47157,26,Primarily Online,19,45
University of Saint Katherine,488785,"Primarily online, with delayed transition to in-person instruction",https://www.usk.edu/covid19,06073,163,Primarily Online,39,202
University of Pittsburgh-Titusville,215309,"Primarily online, with delayed transition to in-person instruction",https://www.titusville.pitt.edu/guidelines-responding-symptomatic-individuals,42039,187,Primarily Online,53,240
Dabney S Lancaster Community College,231873,"Primarily online, with delayed transition to in-person instruction",https://www.dslcc.edu/coronavirus-community-resources,51005,405,Primarily Online,94,499
University of Minnesota-Rochester,456959,"Primarily online, with delayed transition to in-person instruction",https://r.umn.edu/campus-communications,27109,515,Primarily Online,90,605
University of Akron Wayne College,200846,"Primarily online, with delayed transition to in-person instruction",https://wayne.uakron.edu/home/,39169,581,Primarily Online,83,664
Randolph College,233301,"Primarily online, with delayed transition to in-person instruction",,51680,608,Primarily Online,252,860
Tougaloo College,176406,"Primarily online, with delayed transition to in-person instruction",https://www.tougaloo.edu/coronavirus-covid-19-update-1,28089,702,Primarily Online,276,978
Mid-Plains Community College,181312,"Primarily online, with delayed transition to in-person instruction",http://www.mpcc.edu/coronavirusinformation,31111,765,Primarily Online,323,1088
Brescia University,156356,"Primarily online, with delayed transition to in-person instruction",https://www.brescia.edu/covid-19/,21059,802,Primarily Online,158,960
Hope International University,120537,"Primarily online, with delayed transition to in-person instruction",https://www.hiu.edu/about-hiu/news-and-events/press-releases-detail.php?id=438,06059,919,Primarily Online,194,1113
Georgia Piedmont Technical College,244446,"Primarily online, with delayed transition to in-person instruction",https://www.gptc.edu/coronavirus-covid-19-updates/covid-19-student-faq-resources/,13089,922,Primarily Online,308,1230
Hawaii Community College,383190,"Primarily online, with delayed transition to in-person instruction",https://hawaii.hawaii.edu/covid-19,15001,1044,Primarily Online,253,1297
Mars Hill University,198899,"Primarily online, with delayed transition to in-person instruction",https://www.mhu.edu/about/return-to-campus/,37115,1088,Primarily Online,295,1383
The University of Virginia's College at Wise,233897,"Primarily online, with delayed transition to in-person instruction",https://www.uvawise.edu/uva-wise/administration-services/emergency-preparedness/covid-19-information/,51195,1153,Primarily Online,354,1507
Hartwick College,191533,"Primarily online, with delayed transition to in-person instruction",https://www.hartwick.edu/about-us/reopening-our-campus/,36077,1156,Primarily Online,305,1461
Washington & Jefferson College,216667,"Primarily online, with delayed transition to in-person instruction",https://www.washjeff.edu/tag/coronavirus/,42125,1351,Primarily Online,372,1723
Dominican University of California,113698,"Primarily online, with delayed transition to in-person instruction",https://www.dominican.edu/fall-reopening-plan,06041,1430,Primarily Online,392,1822
Randolph-Macon College,233295,"Primarily online, with delayed transition to in-person instruction",https://www.rmc.edu/campus-life/student-health-center/covid-19,51085,1464,Primarily Online,407,1871
Western New Mexico University,188304,"Primarily online, with delayed transition to in-person instruction",https://wnmu.edu/covid-19-updates/,35017,1483,Primarily Online,375,1858
Bloomfield College,183822,"Primarily online, with delayed transition to in-person instruction",https://bloomfield.edu/campus-life/campus-security/campus-alerts/coronavirus-updates,34013,1570,Primarily Online,286,1856
Tompkins Cortland Community College,196565,"Primarily online, with delayed transition to in-person instruction",https://www.tompkinscortland.edu/coronavirus,36109,1605,Primarily Online,318,1923
Mississippi Valley State University,176044,"Primarily online, with delayed transition to in-person instruction",https://www.mvsu.edu/coronavirus-response,28083,1636,Primarily Online,440,2076
Chaminade University of Honolulu,141486,"Primarily online, with delayed transition to in-person instruction",https://chaminade.edu/coronavirus/,15003,1715,Primarily Online,315,2030
Miami University-Hamilton,204006,"Primarily online, with delayed transition to in-person instruction",https://miamioh.edu/coronavirus/,39017,1795,Primarily Online,229,2024
Hocking College,203155,"Primarily online, with delayed transition to in-person instruction",https://info.hocking.edu/coronavirus,39009,1829,Primarily Online,225,2054
West Liberty University,237932,"Primarily online, with delayed transition to in-person instruction",https://westliberty.edu/coronavirus/,54069,1994,Primarily Online,333,2327
The College of Wooster,206589,"Primarily online, with delayed transition to in-person instruction",https://www.wooster.edu/info/fall-2020-guide/,39169,1996,Primarily Online,692,2688
Claflin University,217873,"Primarily online, with delayed transition to in-person instruction",https://www.claflin.edu/student-life/services-support/health-services/covid-19-resource-center,45075,2055,Primarily Online,360,2415
Assumption College,164562,"Primarily online, with delayed transition to in-person instruction",https://www.assumption.edu/people-and-departments/organization-listing/office-president/responding-covid-19-coronavirus,25027,2110,Primarily Online,400,2510
Macalester College,173902,"Primarily online, with delayed transition to in-person instruction",https://www.macalester.edu/covid-19/,27123,2140,Primarily Online,665,2805
SUNY Polytechnic Institute,196112,"Primarily online, with delayed transition to in-person instruction",https://sunypoly.edu/fall2020plan.html,36065,2145,Primarily Online,442,2587
University of Evansville,150534,"Primarily online, with delayed transition to in-person instruction",https://www.evansville.edu/coronavirus/,18163,2182,Primarily Online,496,2678
Gustavus Adolphus College,173647,"Primarily online, with delayed transition to in-person instruction",https://gustavus.edu/healthservice/coronavirus/?utm_source=promolink&utm_medium=web&utm_campaign=covid19,27103,2213,Primarily Online,623,2836
Otterbein University,204936,"Primarily online, with delayed transition to in-person instruction",https://www.otterbein.edu/covid19/,39049,2328,Primarily Online,491,2819
East Mississippi Community College,175652,"Primarily online, with delayed transition to in-person instruction",http://www.eastms.edu/coronavirus/,28069,2360,Primarily Online,392,2752
Gettysburg College,212674,"Primarily online, with delayed transition to in-person instruction",https://www.gettysburg.edu/opening/coronavirus-covid19,42001,2433,Primarily Online,812,3245
Rhode Island School of Design,217493,"Primarily online, with delayed transition to in-person instruction",https://covid.risd.edu/,44007,2467,Primarily Online,939,3406
University of Pittsburgh-Johnstown,215284,"Primarily online, with delayed transition to in-person instruction",https://www.coronavirus.pitt.edu/operational-postures,42021,2542,Primarily Online,322,2864
Oberlin College,204501,"Primarily online, with delayed transition to in-person instruction",https://www.oberlin.edu/news/corona-virus-updates,39093,2785,Primarily Online,997,3782
Capital University,201548,"Primarily online, with delayed transition to in-person instruction",https://www.capital.edu/coronavirus/,39049,2799,Primarily Online,508,3307
Alcorn State University,175342,"Primarily online, with delayed transition to in-person instruction",https://www.alcorn.edu/discover-alcorn/coronavirus,28021,3009,Primarily Online,687,3696
Lock Haven University,213613,"Primarily online, with delayed transition to in-person instruction",http://www.lockhaven.edu/virusinfo/virusfaq.html,42035,3020,Primarily Online,502,3522
Fairleigh Dickinson University-Florham Campus,184694,"Primarily online, with delayed transition to in-person instruction",https://www.fdu.edu/coronavirus-update/,34027,3172,Primarily Online,502,3674
Jones County Junior College,175883,"Primarily online, with delayed transition to in-person instruction",https://www.jcjc.edu/covid-19/,28067,3278,Primarily Online,371,3649
Iona College,191931,"Primarily online, with delayed transition to in-person instruction",https://www.iona.edu/student-life/health-wellness-safety/information-on-coronavirus.aspx,36119,3306,Primarily Online,611,3917
Concordia University-Irvine,112075,"Primarily online, with delayed transition to in-person instruction",https://www.cui.edu/covid-19,06059,3381,Primarily Online,454,3835
Rider University,186283,"Primarily online, with delayed transition to in-person instruction",https://www.rider.edu/resolved-and-ready,34021,3838,Primarily Online,860,4698
California Lutheran University,110413,"Primarily online, with delayed transition to in-person instruction",https://www.callutheran.edu/coronavirus/,06111,3961,Primarily Online,697,4658
University of Mary Washington,232681,"Primarily online, with delayed transition to in-person instruction",https://www.umw.edu/advisories/coronavirus/,51630,3994,Primarily Online,794,4788
Western Connecticut State University,130776,"Primarily online, with delayed transition to in-person instruction",https://www.wcsu.edu/reopen/,09001,4181,Primarily Online,752,4933
Bluegrass Community and Technical College,156392,"Primarily online, with delayed transition to in-person instruction",https://bluegrass.kctcs.edu/covid-19/index.aspx,21067,4271,Primarily Online,645,4916
Norfolk State University,232937,"Primarily online, with delayed transition to in-person instruction",https://www.nsu.edu/Coronavirus,51710,4507,Primarily Online,1106,5613
Winthrop University,218964,"Primarily online, with delayed transition to in-person instruction",https://www.winthrop.edu/emergency/coronavirus.aspx,45091,4703,Primarily Online,929,5632
Bradley University,143358,"Primarily online, with delayed transition to in-person instruction",https://www.bradley.edu/coronavirus/,17143,4839,Primarily Online,1074,5913
Christopher Newport University,231712,"Primarily online, with delayed transition to in-person instruction",https://cnu.edu/coronavirus/,51700,4869,Primarily Online,1129,5998
Westfield State University,168263,"Primarily online, with delayed transition to in-person instruction",https://www.westfield.ma.edu/student-life/health-services/coronavirus-update,25013,4893,Primarily Online,857,5750
Butler University,150163,"Primarily online, with delayed transition to in-person instruction",https://www.butler.edu/on-campus-plan,18097,4955,Primarily Online,1212,6167
Humboldt State University,115755,"Primarily online, with delayed transition to in-person instruction",https://covid19.humboldt.edu/,06023,7148,Primarily Online,994,8142
Belmont University,219709,"Primarily online, with delayed transition to in-person instruction",http://www.belmont.edu/health-services/coronavirus/index.html,47037,7521,Primarily Online,1185,8706
College of William and Mary,231624,"Primarily online, with delayed transition to in-person instruction",https://www.wm.edu/about/administration/emergency/current_issues/coronavirus/index.php,51830,7986,Primarily Online,2610,10596
University of California-Merced,445188,"Primarily online, with delayed transition to in-person instruction",https://emergency.ucmerced.edu/coronavirus,06047,8472,Primarily Online,1599,10071
Chapman University,111948,"Primarily online, with delayed transition to in-person instruction",https://cusafelyback.chapman.edu/,06059,8598,Primarily Online,1741,10339
Coastal Carolina University,218724,"Primarily online, with delayed transition to in-person instruction",https://www.coastal.edu/services/safety_and_security/covid-19/,45051,9135,Primarily Online,1564,10699
College of Charleston,217819,"Primarily online, with delayed transition to in-person instruction",http://cofc.edu/covid19/,45019,9358,Primarily Online,1712,11070
University of Minnesota-Duluth,174233,"Primarily online, with delayed transition to in-person instruction",https://www.d.umn.edu/coronavirus/,27137,9453,Primarily Online,1495,10948
Brown University,217156,"Primarily online, with delayed transition to in-person instruction",https://healthy.brown.edu/,44007,9648,Primarily Online,4443,14091
University of Wyoming,240727,"Primarily online, with delayed transition to in-person instruction",http://www.uwyo.edu/alerts/campus-return/,56001,9955,Primarily Online,2814,12769
University of Dayton,202480,"Primarily online, with delayed transition to in-person instruction",https://udayton.edu/studev/housing/resources/covid_19.php,39113,10037,Primarily Online,2943,12980
Kean University,185262,"Primarily online, with delayed transition to in-person instruction",https://www.kean.edu/return-campus,34039,10674,Primarily Online,1289,11963
University of Southern Mississippi,176372,"Primarily online, with delayed transition to in-person instruction",https://www.usm.edu/covid-19/index.php,28035,11156,Primarily Online,2328,13484
Eastern Michigan University,169798,"Primarily online, with delayed transition to in-person instruction",https://www.emich.edu/coronavirus/index.php,26161,12358,Primarily Online,1794,14152
University of Memphis,220862,"Primarily online, with delayed transition to in-person instruction",https://www.memphis.edu/coronavirusupdates/,47157,13980,Primarily Online,2868,16848
Miami University-Oxford,204024,"Primarily online, with delayed transition to in-person instruction",https://www.miamioh.edu/coronavirus,39017,17712,Primarily Online,3357,21069
Illinois State University,145813,"Primarily online, with delayed transition to in-person instruction",https://coronavirus.illinoisstate.edu/,17113,18207,Primarily Online,3281,21488
Towson University,164076,"Primarily online, with delayed transition to in-person instruction",https://www.towson.edu/coronavirus/,24005,18385,Primarily Online,2711,21096
Clemson University,217882,"Primarily online, with delayed transition to in-person instruction",https://www.clemson.edu/coronavirus/index.html,45077,21940,Primarily Online,5306,27246
Miami Dade College,135717,"Primarily online, with delayed transition to in-person instruction",https://www.mdc.edu/coronavirus/,12086,22292,Primarily Online,4430,26722
University of Virginia-Main Campus,234076,"Primarily online, with delayed transition to in-person instruction",https://returntogrounds.virginia.edu/?utm_source=StudentsOnGrounds&utm_medium=referral&utm_campaign=Fall2020,51003,22509,Primarily Online,9924,32433
University of North Carolina at Charlotte,199139,"Primarily online, with delayed transition to in-person instruction",https://emergency.uncc.edu/health-advisories/coronavirus-information/coronavirus-campus-updates,37119,23589,Primarily Online,3815,27404
West Virginia University,238032,"Primarily online, with delayed transition to in-person instruction",https://www.wvu.edu/return-to-campus,54061,23846,Primarily Online,5916,29762
Northern Arizona University,105330,"Primarily online, with delayed transition to in-person instruction",https://nau.edu/coronavirus,04005,23853,Primarily Online,3417,27270
University of Pittsburgh-Pittsburgh Campus,215293,"Primarily online, with delayed transition to in-person instruction",https://www.coronavirus.pitt.edu/covid-19-campus,42003,25901,Primarily Online,12934,38835
San Diego State University,122409,"Primarily online, with delayed transition to in-person instruction",https://sa.sdsu.edu/student-health-services/coronavirus,06073,30451,Primarily Online,3055,33506
Temple University,216339,"Primarily online, with delayed transition to in-person instruction",https://www.temple.edu/coronavirus,42101,34382,Primarily Online,7689,42071
University of Arizona,104179,"Primarily online, with delayed transition to in-person instruction",https://www.arizona.edu/coronavirus-covid-19-information,04019,36213,Primarily Online,11322,47535
University of Maryland-College Park,163286,"Primarily online, with delayed transition to in-person instruction",https://umd.edu/virusinfo,24033,36603,Primarily Online,9527,46130
University of Wisconsin-Madison,240444,"Primarily online, with delayed transition to in-person instruction",https://covid19.wisc.edu/,55025,39045,Primarily Online,16811,55856
University of California-Berkeley,110635,"Primarily online, with delayed transition to in-person instruction",https://coronavirus.berkeley.edu/,06001,39393,Primarily Online,11099,50492
University of Minnesota-Twin Cities,174066,"Primarily online, with delayed transition to in-person instruction",https://safe-campus.umn.edu/public-health-alerts,27053,39763,Primarily Online,17164,56927
University of Southern California,123961,"Primarily online, with delayed transition to in-person instruction",https://coronavirus.usc.edu/,06037,40952,Primarily Online,15151,56103
Southwest Collegiate Institute for the Deaf,382911,Professor's choice,https://howardcollege.edu/special-notice/,48227,80,Hybrid,39,119
Antioch College,483018,Professor's choice,https://antiochcollege.edu/novel-coronavirus/,39057,102,Hybrid,116,218
Kent State University at East Liverpool,203456,Professor's choice,https://www.kent.edu/coronavirus,39029,104,Hybrid,52,156
Central Pennsylvania Institute of Science and Technology,369668,Professor's choice,https://cpi.edu/phased-return-of-cpi-post-secondary-students-beginning-june-9th/,42027,161,Hybrid,30,191
Calvary University,176789,Professor's choice,https://www.calvary.edu/covid-19/,29037,211,Hybrid,86,297
Holy Apostles College and Seminary,129534,Professor's choice,https://holyapostles.edu/coronavirus/,09007,228,Hybrid,45,273
Franklin W Olin College of Engineering,441982,Professor's choice,http://www.olin.edu/campus/emergency-preparedness/,25021,345,Hybrid,129,474
North Florida Community College,136145,Professor's choice,https://www.nfc.edu/alerts/,12079,369,Hybrid,124,493
Carteret Community College,198206,Professor's choice,https://www.carteret.edu/coronavirus-covid-19/,37031,482,Hybrid,250,732
Phillips Community College of the University of Arkansas,107619,Professor's choice,https://www.pccua.edu/about/coronavirus-disease,05107,608,Hybrid,210,818
Stillman College,102270,Professor's choice,https://stillman.edu/coronavirus-stillman-response/,01125,660,Hybrid,164,824
Kent State University at Tuscarawas,203483,Professor's choice,https://www.kent.edu/tusc/coronavirus-updates-tuscarawas,39157,748,Hybrid,155,903
Naropa University,127653,Professor's choice,https://www.naropa.edu/coronavirus/index.php,08013,767,Hybrid,252,1019
Brazosport College,223506,Professor's choice,https://brazosport.edu/coronavirus/,48039,825,Hybrid,421,1246
University of New Mexico-Gallup Campus,187958,Professor's choice,https://www.gallup.unm.edu/coronavirus/cv19-updates.php,35031,883,Hybrid,160,1043
Harcum College,212869,Professor's choice,https://www.harcum.edu/s/1044/edu/index.aspx?sid=1044&gid=1&pgid=2810,42091,942,Hybrid,275,1217
Notre Dame of Maryland University,163578,Professor's choice,https://www.ndm.edu/ndmu-together,24510,953,Hybrid,315,1268
Union College,157863,Professor's choice,https://www.union.edu/coronavirus,21121,1016,Hybrid,221,1237
Milligan College,486901,Professor's choice,https://www.milligan.edu/returnhome,47019,1046,Hybrid,246,1292
Connors State College,206996,Professor's choice,https://connorsstate.edu/covid-19-student-resources,40101,1183,Hybrid,128,1311
Lane College,220598,Professor's choice,https://www.lanecollege.edu/news/a-letter-to-students-on-reopening,47113,1184,Hybrid,209,1393
Howard College,225520,Professor's choice,https://howardcollege.edu/special-notice/,48227,1242,Hybrid,281,1523
Vaughn College of Aeronautics and Technology,188340,Professor's choice,https://www.vaughn.edu/coronavirus/,36081,1297,Hybrid,217,1514
Haverford College,212911,Professor's choice,https://www.haverford.edu/coronavirus-information,42045,1308,Hybrid,614,1922
William Jessup University,122728,Professor's choice,https://jessup.edu/coronavirus-information,06061,1380,Hybrid,292,1672
Reed College,209922,Professor's choice,https://www.reed.edu/coronavirus/,41051,1453,Hybrid,540,1993
Dominican College of Blauvelt,190761,Professor's choice,https://www.dc.edu/novel-coronavirus-information/,36087,1502,Hybrid,275,1777
Grayson College,225070,Professor's choice,https://grayson.edu/campus-life/campus-police/Coronavirus%20Info/index.html,48181,1547,Hybrid,400,1947
Saint Vincent College,215798,Professor's choice,https://www.stvincent.edu/student-life/coronavirus-update,42129,1717,Hybrid,401,2118
Mineral Area College,178217,Professor's choice,https://mineralarea.edu/Covid-19,29187,1742,Hybrid,240,1982
The University of the South,221519,Professor's choice,https://new.sewanee.edu/2019-novel-coronavirus-covid-19/,47051,1744,Hybrid,737,2481
University of South Carolina-Beaufort,218654,Professor's choice,https://www.uscb.edu/coronavirus/,45013,1797,Hybrid,280,2077
Davidson College,198385,Professor's choice,https://www.davidson.edu/covid-19/fall-2020,37119,1843,Hybrid,850,2693
Adams State University,126182,Professor's choice,,08003,1878,Hybrid,406,2284
Saint Johns River State College,137281,Professor's choice,http://www.sjrstate.edu/coronavirus/,12107,1881,Hybrid,476,2357
Gulf Coast State College,134343,Professor's choice,https://www.gulfcoast.edu/covid-19-coronavirus.html,12005,1886,Hybrid,427,2313
Hardin-Simmons University,225247,Professor's choice,https://www.hsutx.edu/covid-19-information/,48441,1944,Hybrid,340,2284
Roanoke College,233426,Professor's choice,https://www.roanoke.edu/covid19,51775,1956,Hybrid,454,2410
Hamilton College,191515,Professor's choice,https://www.hamilton.edu/returning-to-campus,36065,1991,Hybrid,716,2707
Moravian College,214157,Professor's choice,https://www.moravian.edu/healthcenter/covid-19,42095,2001,Hybrid,492,2493
Carleton College,173258,Professor's choice,https://www.carleton.edu/covid/,27131,2077,Hybrid,692,2769
Aims Community College,126207,Professor's choice,https://www.aims.edu/coronavirus/,08123,2157,Hybrid,558,2715
Vassar College,197133,Professor's choice,https://www.vassar.edu/coronavirus-updates/,36027,2442,Hybrid,1025,3467
St Lawrence University,195216,Professor's choice,https://www.stlawu.edu/covid-19,36089,2449,Hybrid,750,3199
Mercyhurst University,213987,Professor's choice,https://www.mercyhurst.edu/covid19,42049,2501,Hybrid,463,2964
SUNY Morrisville,196051,Professor's choice,https://www.morrisville.edu/coronavirus,36053,2508,Hybrid,534,3042
Trinity University,229267,Professor's choice,https://sites.google.com/trinity.edu/trinityuniversitycovid-19,48029,2548,Hybrid,839,3387
Middlebury College,230959,Professor's choice,https://www.middlebury.edu/office/announcements,50001,2551,Hybrid,1136,3687
Flagler College-St Augustine,133711,Professor's choice,https://www.flagler.edu/campus-community/news/coronavirus/,12109,2555,Hybrid,425,2980
Nazareth College,193584,Professor's choice,https://www2.naz.edu/return-campus,36055,2565,Hybrid,559,3124
Champlain College,230852,Professor's choice,https://view.champlain.edu/2020/05/21/updates-on-the-coronavirus-covid-19/,50007,2575,Hybrid,478,3053
Skidmore College,195526,Professor's choice,https://www.skidmore.edu/fall-planning/fall-plan.php,36091,2585,Hybrid,979,3564
SUNY College of Technology at Canton,196015,Professor's choice,https://www.canton.edu/restart/,36089,2743,Hybrid,444,3187
The College of Saint Rose,195234,Professor's choice,https://www.strose.edu/restart/,36001,2831,Hybrid,594,3425
Colgate University,190099,Professor's choice,https://www.colgate.edu/covid-19-response,36053,2944,Hybrid,1035,3979
Wesleyan University,130697,Professor's choice,https://www.wesleyan.edu/healthservices/coronavirus/,09007,3052,Hybrid,982,4034
Utica College,197045,Professor's choice,https://www.utica.edu/reopen,36065,3152,Hybrid,574,3726
University of Alaska Fairbanks,102614,Professor's choice,https://sites.google.com/alaska.edu/coronavirus/uaf?authuser=0,02090,3237,Hybrid,1924,5161
McLennan Community College,226578,Professor's choice,https://www.mclennan.edu/crisis-management/coronavirus-updates/index.html,48309,3338,Hybrid,669,4007
Saint Edward's University,227845,Professor's choice,https://www.stedwards.edu/healthy-hilltop,48453,3589,Hybrid,711,4300
SUNY Broome Community College,189547,Professor's choice,http://www3.sunybroome.edu/coronavirus/,36007,3771,Hybrid,531,4302
University of Scranton,215929,Professor's choice,https://www.scranton.edu/covid-19/index.shtml,42069,4119,Hybrid,973,5092
SUNY at Fredonia,196158,Professor's choice,https://www.fredonia.edu/returning,36013,4465,Hybrid,721,5186
Ashland University,201104,Professor's choice,https://www.ashland.edu/covid-19,39005,4524,Hybrid,899,5423
University of South Carolina-Upstate,218742,Professor's choice,https://www.uscupstate.edu/announcements/,45083,4744,Hybrid,678,5422
SUNY College at Plattsburgh,196246,Professor's choice,https://www.plattsburgh.edu/covid-19/index.html,36019,5123,Hybrid,847,5970
Indian River State College,134608,Professor's choice,https://www.irsc.edu/coronavirus-update.html,12111,5380,Hybrid,1101,6481
SUNY College at Geneseo,196167,Professor's choice,https://www.geneseo.edu/coronavirus,36051,5423,Hybrid,830,6253
Thomas Jefferson University,216366,Professor's choice,https://www.jefferson.edu/coronavirus.html,42101,5753,Hybrid,4283,10036
Gonzaga University,235316,Professor's choice,https://www.gonzaga.edu/zagon,53063,5844,Hybrid,1475,7319
Tyler Junior College,229355,Professor's choice,https://www.tjc.edu/coronavirus,48423,6026,Hybrid,898,6924
Florida SouthWestern State College,133508,Professor's choice,https://www.fsw.edu/reconnect/coursedelivery,12071,6072,Hybrid,824,6896
Angelo State University,222831,Professor's choice,https://www.angelo.edu/covid-19/returning-to-campus/,48451,6264,Hybrid,849,7113
SUNY College at Brockport,196121,Professor's choice,https://brockport.edu/coronavirus/index.html,36055,6696,Hybrid,1145,7841
Rice University,227757,Professor's choice,https://coronavirus.rice.edu/,48201,6765,Hybrid,3314,10079
SUNY College at Oswego,196194,Professor's choice,https://ww1.oswego.edu/oswego-forward/,36075,7104,Hybrid,1182,8286
Austin Peay State University,219602,Professor's choice,https://www.apsu.edu/coronavirus/,47125,7325,Hybrid,1151,8476
Texas Southern University,229063,Professor's choice,http://www.tsu.edu/about/administration/marketing-and-communications/coronavirus/index.html,48201,8027,Hybrid,1251,9278
Southern Methodist University,228246,Professor's choice,https://blog.smu.edu/coronavirus-covid-19/,48113,8895,Hybrid,2577,11472
Blinn College,223427,Professor's choice,http://www.blinn.edu/back-with-blinn/index.html,48477,9431,Hybrid,995,10426
Stephen F Austin State University,228431,Professor's choice,http://www.sfasu.edu/life-at-sfa/health-safety/health-clinic/coronavirus,48347,9914,Hybrid,1542,11456
Weber State University,230782,Professor's choice,https://weber.edu/coronavirus,49057,11774,Hybrid,1754,13528
Metropolitan State University of Denver,127565,Professor's choice,https://www.msudenver.edu/coronavirus-update/,08031,13182,Hybrid,1667,14849
Fordham University,191241,Professor's choice,https://www.fordham.edu/info/29768/fordham_forward,36005,13736,Hybrid,2713,16449
University of Chicago,144050,Professor's choice,https://coronavirusupdates.uchicago.edu/,17031,14966,Hybrid,11032,25998
SUNY at Albany,196060,Professor's choice,https://www.albany.edu/covid-19,36001,15056,Hybrid,2673,17729
Duke University,198419,Professor's choice,https://returnto.duke.edu/,37063,15700,Hybrid,18793,34493
George Mason University,232186,Professor's choice,https://www2.gmu.edu/news/586996,51059,25710,Hybrid,4704,30414
University at Buffalo,196088,Professor's choice,https://www.buffalo.edu/coronavirus/dashboard.html,36029,26475,Hybrid,4846,31321
University of North Texas,227216,Professor's choice,https://healthalerts.unt.edu/,48121,28441,Hybrid,3970,32411
University of California-Davis,110644,Professor's choice,https://www.ucdavis.edu/coronavirus/,06113,36919,Hybrid,12805,49724
Messenger College,417752,Simultaneous teaching,https://www.messengercollege.edu/coronavirus-covid-19-update,48439,34,Hybrid,12,46
Kentucky Mountain Bible College,157030,Simultaneous teaching,https://www.kmbc.edu/covid19/,21025,47,Hybrid,21,68
Hebrew Theological College,145497,Simultaneous teaching,http://www.htc.edu/component/k2/item/265-covid-19-camp-updates-1.html,17031,75,Hybrid,59,134
Emmaus Bible College,153302,Simultaneous teaching,https://www.emmaus.edu/fall-readiness,19061,219,Hybrid,66,285
Pennsylvania State University-Penn State Shenango,214634,Simultaneous teaching,https://shenango.psu.edu/feature/coronavirus-information,42085,230,Hybrid,0,230
The Baptist College of Florida,132408,Simultaneous teaching,http://www.baptistcollege.edu/news_events/page.asp?content=news-press_2020,12063,261,Hybrid,93,354
Pennsylvania Academy of the Fine Arts,214971,Simultaneous teaching,https://www.pafa.org/news/coronavirus-information-resources,42101,271,Hybrid,136,407
Bryn Athyn College of the New Church,210492,Simultaneous teaching,https://brynathyn.edu/covid-19-update/,42091,292,Hybrid,143,435
James Sprunt Community College,198729,Simultaneous teaching,https://www.nccommunitycolleges.edu/covid-19-response,37061,334,Hybrid,213,547
The King's University,439701,Simultaneous teaching,https://www.tku.edu/news/coronavirus/,48439,338,Hybrid,87,425
Pennsylvania State University-Penn State Wilkes-Barre,214643,Simultaneous teaching,https://wilkesbarre.psu.edu/coronavirus,42079,366,Hybrid,0,366
Pennsylvania State University-Penn State Greater Allegheny,214786,Simultaneous teaching,https://virusinfo.psu.edu/,42003,417,Hybrid,0,417
Pennsylvania State University-Penn State DuBois,214740,Simultaneous teaching,https://virusinfo.psu.edu/,42033,447,Hybrid,0,447
Southeast Arkansas College,107637,Simultaneous teaching,https://www.seark.edu/covid-19-response,05069,468,Hybrid,166,634
Pennsylvania State University-Penn State New Kensington,214625,Simultaneous teaching,https://newkensington.psu.edu/coronavirus-information,42129,489,Hybrid,0,489
Pennsylvania State University-Penn State Schuylkill,214810,Simultaneous teaching,https://schuylkill.psu.edu/coronavirus,42107,490,Hybrid,0,490
University of Valley Forge,216542,Simultaneous teaching,https://valleyforge.edu/campus-life/counseling-and-health-center/covid-19-update/,42029,492,Hybrid,104,596
Northwest University-College of Adult and Professional Studies,487603,Simultaneous teaching,https://www.northwestu.edu/coronavirus/https:/eagle.northwestu.edu/departments/registrar/Primarily/,53033,517,Hybrid,58,575
Pacific Northwest College of Art,209603,Simultaneous teaching,https://pnca.edu/lifeatpnca/safety-security/health-safety,41051,537,Hybrid,139,676
Lincoln University,117557,Simultaneous teaching,http://lincolnuca.edu/about/presidentletter#%2Fabout%2Fpresidentletter,06001,548,Hybrid,43,591
Pennsylvania State University-Penn State Beaver,214698,Simultaneous teaching,https://virusinfo.psu.edu/,42007,548,Hybrid,0,548
Arkansas Northeastern College,107327,Simultaneous teaching,https://docs.google.com/document/d/e/2PACX-1vTdEFHT1TDZptO_2uvOaMcXVt_ro05IFwBzDoO6Qljm4Bx7JupDvk1ltFZYUTuzYkEIWqwy8nYW3MHX/pub,05093,555,Hybrid,192,747
Ozarka College,107549,Simultaneous teaching,https://otc.ozarka.edu/campusnews_view.cfm?uuid=D42F89D9-1422-B139-DAFF61A04AF5C14D,05065,562,Hybrid,118,680
Pennsylvania State University-Penn State Fayette- Eberly,214759,Simultaneous teaching,https://virusinfo.psu.edu/,42051,570,Hybrid,0,570
Stephens College,179548,Simultaneous teaching,https://www.stephens.edu/covid/,29019,601,Hybrid,209,810
Kansas Wesleyan University,155414,Simultaneous teaching,https://www.kwu.edu/coronavirus,20169,605,Hybrid,170,775
Arizona Christian University,105899,Simultaneous teaching,https://www.arizonachristian.edu/covid-19-updates/,04013,642,Hybrid,196,838
Bluffton University,201371,Simultaneous teaching,https://www.bluffton.edu/alert/,39003,667,Hybrid,151,818
University of Maine at Presque Isle,161341,Simultaneous teaching,https://www.umpi.edu/return/,23003,672,Hybrid,154,826
Eastern Nazarene College,165644,Simultaneous teaching,https://enc.edu/covid-19-information/,25021,677,Hybrid,165,842
Trinidad State Junior College,128258,Simultaneous teaching,http://www.trinidadstate.edu/alert/index.html,08071,682,Hybrid,166,848
McPherson College,155511,Simultaneous teaching,https://www.mcpherson.edu/covid/,20113,706,Hybrid,151,857
Rochester College,170967,Simultaneous teaching,https://rochesteru.edu/coronavirus/,26125,724,Hybrid,156,880
Southwestern College,155900,Simultaneous teaching,https://www.sckans.edu/other/campus-health-updates,20035,727,Hybrid,215,942
Boricua College,189413,Simultaneous teaching,http://boricuacollege.edu/covid-19-health-emergency/,36061,731,Hybrid,131,862
Pennsylvania State University-Penn State Lehigh Valley,214670,Simultaneous teaching,https://lehighvalley.psu.edu/covid19,42077,764,Hybrid,0,764
Bennington College,230816,Simultaneous teaching,https://www.bennington.edu/covid-19-updates-and-information,50003,780,Hybrid,296,1076
Richard Bland College,233338,Simultaneous teaching,https://www.rbc.edu/campus-life/coronavirus-info-center/,51053,842,Hybrid,151,993
Valley City State University,200572,Simultaneous teaching,http://www.vcsu.edu/news/coronavirus-information,38003,872,Hybrid,194,1066
Pennsylvania State University-Penn State Scranton,214652,Simultaneous teaching,https://virusinfo.psu.edu/,42069,896,Hybrid,0,896
Lenoir Community College,198817,Simultaneous teaching,https://www.lenoircc.edu/coronavirus,37107,909,Hybrid,333,1242
McMurry University,226587,Simultaneous teaching,https://services.mcm.edu/health/coronavirus.html,48441,990,Hybrid,243,1233
Bluefield College,231554,Simultaneous teaching,http://www.bluefield.edu/covid-19-information/,51185,1008,Hybrid,163,1171
University of South Florida-Sarasota-Manatee,451671,Simultaneous teaching,https://www.usf.edu/coronavirus/index.aspx,12081,1051,Hybrid,227,1278
Southside Virginia Community College,233639,Simultaneous teaching,https://southside.edu/covid-19,51025,1091,Hybrid,212,1303
Keystone College,213303,Simultaneous teaching,https://www.keystone.edu/coronavirus-disease-covid-19/covid19/,42131,1124,Hybrid,215,1339
Malone University,203775,Simultaneous teaching,https://www.malone.edu/coronavirus-periodic-update/coronavirus-qa/,39151,1143,Hybrid,254,1397
Hood College,162760,Simultaneous teaching,https://www.hood.edu/discover/welcome-home-blazers/academics-classrooms,24021,1174,Hybrid,302,1476
Northwest University,236133,Simultaneous teaching,https://www.northwestu.edu/coronavirus/,53033,1190,Hybrid,275,1465
East Texas Baptist University,224527,Simultaneous teaching,https://www.etbu.edu/etbu-now/coronavirus-covid-19-information,48203,1327,Hybrid,256,1583
Juniata College,213251,Simultaneous teaching,https://www.juniata.edu/coronavirus/,42061,1348,Hybrid,345,1693
Johnston Community College,198774,Simultaneous teaching,https://www.johnstoncc.edu/campus-safety/coronavirus/index.aspx,37101,1355,Hybrid,461,1816
Concordia University Texas,224004,Simultaneous teaching,https://www.concordia.edu/resources/ctx-safety/coronavirus-info.html,48453,1387,Hybrid,248,1635
Lawrence University,239017,Simultaneous teaching,https://blogs.lawrence.edu/covid-19/,55087,1420,Hybrid,505,1925
Cochise County Community College District,104425,Simultaneous teaching,https://www.cochise.edu/fall-2020-semester/,04003,1481,Hybrid,425,1906
Felician University,184612,Simultaneous teaching,https://felician.edu/covid/,34003,1544,Hybrid,335,1879
Cornerstone University,170037,Simultaneous teaching,https://www.cornerstone.edu/why-cornerstone-university/campus-locations/university-offices/health-services/coronavirus-information,26081,1549,Hybrid,316,1865
Angelina College,222822,Simultaneous teaching,http://www.angelina.edu/coronavirus/,48005,1574,Hybrid,334,1908
University of Cincinnati-Clermont College,201946,Simultaneous teaching,https://ucclermont.edu/coronavirus.html,39025,1618,Hybrid,233,1851
Holy Family University,212984,Simultaneous teaching,https://www.holyfamily.edu/coronavirus-information,42101,1628,Hybrid,343,1971
Cleveland State Community College,219879,Simultaneous teaching,http://www.clevelandstatecc.edu/about/general-info/health-and-safety/covid19-info.html,47011,1656,Hybrid,248,1904
Midwestern Baptist Theological Seminary,178208,Simultaneous teaching,https://www.mbts.edu/coronavirus/,29047,1657,Hybrid,188,1845
Gordon College,165936,Simultaneous teaching,https://www.gordon.edu/reopen,25009,1688,Hybrid,483,2171
Wittenberg University,206525,Simultaneous teaching,https://www.wittenberg.edu/administration/healthwellness/covid-19-health-advisory,39023,1693,Hybrid,344,2037
West Virginia State University,237899,Simultaneous teaching,https://wvstateu.edu/about/focus-on-wvsu.aspx,54039,1694,Hybrid,322,2016
University of Dallas,224323,Simultaneous teaching,https://www.utdallas.edu/coronavirus/,48113,1715,Hybrid,433,2148
Concordia University-Nebraska,180984,Simultaneous teaching,https://www.cune.edu/today/students/health-wellness/health-center/coronavirus-information,31159,1737,Hybrid,237,1974
Wheaton College,168281,Simultaneous teaching,https://www.wheaton.edu/fall-2020-campus-updates/,25005,1751,Hybrid,488,2239
College of Saint Benedict,174747,Simultaneous teaching,https://www.csbsju.edu/covid-19,27145,1764,Hybrid,436,2200
Taylor University,152530,Simultaneous teaching,https://covid19taylor.wpcomstaging.com/,18053,1873,Hybrid,447,2320
Wagner College,197197,Simultaneous teaching,https://wagner.edu/covid19/,36085,1912,Hybrid,489,2401
Mount St. Mary's University,163462,Simultaneous teaching,https://inside.msmary.edu/health-services/covid-19-info.html,24021,2000,Hybrid,446,2446
South Dakota School of Mines and Technology,219347,Simultaneous teaching,https://www.sdsmt.edu/covid-19/,46103,2066,Hybrid,407,2473
Houston Baptist University,225399,Simultaneous teaching,https://hbu.edu/huskystrong/,48201,2079,Hybrid,472,2551
The College of New Rochelle,193645,Simultaneous teaching,https://www.mercy.edu/oncampus-plus,36119,2087,Hybrid,0,2087
Benedict College,217721,Simultaneous teaching,https://www.benedict.edu/re-opening-tiger-nation-fall-2020/,45079,2114,Hybrid,320,2434
Pennsylvania State University-Penn State Berks,214704,Simultaneous teaching,https://berks.psu.edu/penn-state-berks-coronavirus-faq,42011,2277,Hybrid,0,2277
Willamette University,210401,Simultaneous teaching,https://willamette.edu/offices/wellness/coronavirus/index.html,41047,2291,Hybrid,578,2869
University of Mount Union,204185,Simultaneous teaching,https://www.mountunion.edu/alert,39151,2362,Hybrid,473,2835
Denison University,202523,Simultaneous teaching,https://reopen.denison.edu/hc/en-us,39089,2365,Hybrid,752,3117
Marywood University,213826,Simultaneous teaching,http://www.marywood.edu/covid19,42069,2504,Hybrid,550,3054
Roane State Community College,221397,Simultaneous teaching,https://www.roanestate.edu/?12356-Coronavirus-COVID-19,47145,2522,Hybrid,403,2925
Milwaukee School of Engineering,239318,Simultaneous teaching,https://www.msoe.edu/coronavirus/,55079,2529,Hybrid,449,2978
Furman University,218070,Simultaneous teaching,https://www.furman.edu/furman-focused/,45045,2725,Hybrid,971,3696
Rollins College,136950,Simultaneous teaching,https://www.rollins.edu/covid,12095,2784,Hybrid,723,3507
Messiah College,213996,Simultaneous teaching,https://messiah911.wordpress.com,42041,2787,Hybrid,719,3506
Lander University,218229,Simultaneous teaching,https://www.lander.edu/about/coronavirus-covid-19-information,45047,2789,Hybrid,498,3287
Shenandoah University,233541,Simultaneous teaching,https://www.su.edu/blog/category/health/coronavirus/,51840,2909,Hybrid,788,3697
University of South Florida-St Petersburg,448840,Simultaneous teaching,https://www.usf.edu/coronavirus/index.aspx,12103,2909,Hybrid,533,3442
Hult International Business School,164368,Simultaneous teaching,https://www.hult.edu/en/announcements/covid19-update/,25017,2984,Hybrid,223,3207
Point Park University,215442,Simultaneous teaching,https://www.pointpark.edu/StudentLife/HealthandStudentServices/StudentHealthCenter/returnToCampus/covid/index,42003,3022,Hybrid,636,3658
Point Loma Nazarene University,121309,Simultaneous teaching,https://www.pointloma.edu/coronavirus-covid-19-information,06073,3106,Hybrid,724,3830
Pennsylvania State University-Penn State Altoona,214689,Simultaneous teaching,https://altoona.psu.edu/offices-divisions/academic-affairs/registrar/fall-2020-schedule-updates,42013,3125,Hybrid,0,3125
Oral Roberts University,207582,Simultaneous teaching,https://oru.edu/campus-health/index.php,40143,3187,Hybrid,669,3856
University of Cincinnati-Blue Ash College,201955,Simultaneous teaching,https://ucblueash.edu/campus-services.html,39061,3200,Hybrid,339,3539
Gannon University,212601,Simultaneous teaching,https://update.gannon.edu,42049,3268,Hybrid,686,3954
Shasta College,123299,Simultaneous teaching,http://www.shastacollege.edu/Marketing/PR/Pages/Coronavirus-Press-Release.aspx,06089,3286,Hybrid,518,3804
Keene State College,183062,Simultaneous teaching,https://www.keene.edu/office/wellnesscenter/info-on-coronavirus/,33005,3399,Hybrid,581,3980
York College of Pennsylvania,217059,Simultaneous teaching,https://www.ycp.edu/about-us/offices-and-departments/communications/coronavirus/,42133,3760,Hybrid,619,4379
Washburn University,156082,Simultaneous teaching,https://washburn.edu/student-life/health-safety/index.html,20177,4297,Hybrid,836,5133
Arizona State University-Polytechnic,420574,Simultaneous teaching,https://eoss.asu.edu/health/announcements/coronavirus,04013,4372,Hybrid,457,4829
Plymouth State University,183080,Simultaneous teaching,https://www.plymouth.edu/task-force-fall-2020/,33009,4378,Hybrid,638,5016
Harding University,107044,Simultaneous teaching,https://www.harding.edu/public-safety/emergency-management/coronavirus-update,05145,4380,Hybrid,912,5292
Saint Joseph's University,215770,Simultaneous teaching,https://www.sju.edu/hawk-hill-ready/return-to-campus-health-and-safety,42101,4773,Hybrid,1046,5819
University of Arkansas at Little Rock,106245,Simultaneous teaching,https://ualr.edu/coronavirus/,05119,5142,Hybrid,1339,6481
Pittsburg State University,155681,Simultaneous teaching,https://www.pittstate.edu/office/health-services/coronavirus/index.html,20037,5161,Hybrid,818,5979
Northwest Missouri State University,178624,Simultaneous teaching,https://www.nwmissouri.edu/alert/recovery/index.htm,29147,5380,Hybrid,716,6096
Tennessee State University,221838,Simultaneous teaching,http://www.tnstate.edu/covid19/,47037,5666,Hybrid,1291,6957
Mercy College,193016,Simultaneous teaching,https://www.mercy.edu/oncampus-plus,36119,6167,Hybrid,1024,7191
Salisbury University,163851,Simultaneous teaching,https://www.salisbury.edu/news/coronavirus.aspx,24045,7597,Hybrid,1357,8954
Saint Leo University,137032,Simultaneous teaching,https://www.saintleo.edu/coronavirus,12101,9167,Hybrid,1206,10373
Arizona State University-Downtown Phoenix,448886,Simultaneous teaching,https://eoss.asu.edu/health/announcements/coronavirus,04013,10062,Hybrid,1791,11853
Texas Christian University,228875,Simultaneous teaching,https://www.tcu.edu/coronavirus/index.php,48439,10486,Hybrid,2443,12929
Nova Southeastern University,136215,Simultaneous teaching,https://www.nova.edu/coronavirus/index.html,12011,13150,Hybrid,3971,17121
Arizona State University-Skysong,483124,Simultaneous teaching,https://eoss.asu.edu/health/announcements/coronavirus,04013,14115,Hybrid,1488,15603
Boston University,164988,Simultaneous teaching,https://www.bu.edu/covid-19-information/,25025,28287,Hybrid,9556,37843
University of Cincinnati-Main Campus,201885,Simultaneous teaching,https://www.uc.edu/publichealth.html,39061,28655,Hybrid,7032,35687
Arizona State University-Tempe,104151,Simultaneous teaching,https://www.asu.edu/about/fall-2020,04013,46180,Hybrid,9116,55296
Williamson Christian College,443340,"Some of a variety of methods, non-specific plan",https://williamsoncc.edu/williamson-college-covid-19/,47187,44,Hybrid,20,64
Allegheny Wesleyan College,200873,"Some of a variety of methods, non-specific plan",https://awc.edu/coronavirus/,39029,58,Hybrid,25,83
Remington College-Baton Rouge Campus,440271,"Some of a variety of methods, non-specific plan",http://www.remingtoncollege.edu/covid-19/,22033,60,Hybrid,9,69
Herzing University-Toledo,457022,"Some of a variety of methods, non-specific plan",https://www.herzing.edu/coronavirus,39095,65,Hybrid,0,65
Red Lake Nation College,491844,"Some of a variety of methods, non-specific plan",https://www.rlnc.education/,27007,88,Hybrid,27,115
Pacific Rim Christian University,457484,"Some of a variety of methods, non-specific plan",https://www.pacrim.edu/spring20plan,15003,102,Hybrid,20,122
Carolina College of Biblical Studies,461032,"Some of a variety of methods, non-specific plan",https://www.ccbs.edu/covid-19/,37051,122,Hybrid,17,139
Faith International University,443049,"Some of a variety of methods, non-specific plan",https://faithseminary.edu/covid19/,53053,129,Hybrid,31,160
Valor Christian College,486257,"Some of a variety of methods, non-specific plan",https://www.valorcollege.edu/pages/299-covid-19-info-and-emergency-schedule-changes,39049,130,Hybrid,22,152
Arlington Baptist University,222877,"Some of a variety of methods, non-specific plan",https://www.abu.edu/updated-information-on-the-coronavirus1,48439,147,Hybrid,37,184
River Valley Community College,183114,"Some of a variety of methods, non-specific plan",https://www.rivervalley.edu/student-support/information-on-coronavirus/,33019,154,Hybrid,107,261
Virginia International University,460376,"Some of a variety of methods, non-specific plan",https://www.fxua.edu/our-university/about-fxua/institutional-effectiveness/safety-planning/university-updates-on-the-coronavirus-covid-19-pandemic/,51059,210,Hybrid,49,259
Sitting Bull College,200466,"Some of a variety of methods, non-specific plan",https://sittingbull.edu/covid19/,38085,225,Hybrid,114,339
Salina Area Technical College,155830,"Some of a variety of methods, non-specific plan",https://www.salinatech.edu/covid-19-information/,20169,229,Hybrid,68,297
Longy School of Music of Bard College,166489,"Some of a variety of methods, non-specific plan",https://longy.edu/uncategorized/coronavirus-response/,25017,232,Hybrid,101,333
Martin Community College,198905,"Some of a variety of methods, non-specific plan",https://www.martincc.edu/sites/default/files/front/bannerattachments/covid19.pdf,37117,237,Hybrid,137,374
Denmark Technical College,217989,"Some of a variety of methods, non-specific plan",https://www.denmarktech.edu/presidents-statement-on-covid-19/,45009,248,Hybrid,81,329
Herzing University-Akron,200785,"Some of a variety of methods, non-specific plan",https://www.herzing.edu/coronavirus,39153,259,Hybrid,34,293
Cottey College,177117,"Some of a variety of methods, non-specific plan",https://cottey.edu/covid-19/,29217,268,Hybrid,165,433
Remington College-Shreveport Campus,451866,"Some of a variety of methods, non-specific plan",http://www.remingtoncollege.edu/covid-19/,22017,301,Hybrid,36,337
Morgan Community College,127617,"Some of a variety of methods, non-specific plan",https://www.morgancc.edu/covid-19/,08087,306,Hybrid,126,432
Kauai Community College,141802,"Some of a variety of methods, non-specific plan",https://www.kauai.hawaii.edu/coronavirus,15007,328,Hybrid,167,495
Montgomery Community College,199023,"Some of a variety of methods, non-specific plan",,37123,333,Hybrid,139,472
Ohio University-Eastern Campus,204802,"Some of a variety of methods, non-specific plan",https://www.ohio.edu/regional/covid-fall-planning,39013,335,Hybrid,37,372
North American University,461795,"Some of a variety of methods, non-specific plan",https://www.na.edu/coronavirus/,48157,351,Hybrid,64,415
City University of Seattle,234915,"Some of a variety of methods, non-specific plan",https://www.cityu.edu/iso-advisory/,53033,363,Hybrid,282,645
Remington College-Lafayette Campus,160524,"Some of a variety of methods, non-specific plan",http://www.remingtoncollege.edu/covid-19/,22055,368,Hybrid,37,405
Warner Pacific University Professional and Graduate Studies,480198,"Some of a variety of methods, non-specific plan",https://www.warnerpacific.edu/covid-19-faq/,41051,387,Hybrid,23,410
Marion Military Institute,101648,"Some of a variety of methods, non-specific plan",https://marionmilitary.edu/coronavirus/,01105,391,Hybrid,110,501
Garrett College,162609,"Some of a variety of methods, non-specific plan",https://www.garrettcollege.edu/corona-virus.php,24023,421,Hybrid,164,585
Pillar College,440794,"Some of a variety of methods, non-specific plan",https://pillar.edu/coronavirus-info,34013,431,Hybrid,86,517
Halifax Community College,198640,"Some of a variety of methods, non-specific plan",http://halifaxcc.edu/Halifacts/,37083,432,Hybrid,192,624
North Central Kansas Technical College,155593,"Some of a variety of methods, non-specific plan",https://ncktc.edu/covid-19/,20123,436,Hybrid,92,528
Maine College of Art,161509,"Some of a variety of methods, non-specific plan",https://www.meca.edu/article/mecas-2020-2021-welcome-to-campus-plan/,23005,439,Hybrid,121,560
Palo Verde College,120953,"Some of a variety of methods, non-specific plan",http://www.paloverde.edu/safety/health-safety.aspx,06065,441,Hybrid,131,572
Brewton-Parker College,139205,"Some of a variety of methods, non-specific plan",https://bpc.edu/21841,13209,454,Hybrid,97,551
Belmont College,201283,"Some of a variety of methods, non-specific plan",http://belmont.edu/return/index.html,39013,462,Hybrid,94,556
Quinebaug Valley Community College,130217,"Some of a variety of methods, non-specific plan",https://qvcc.edu/corona/,09015,477,Hybrid,115,592
Columbia College Hollywood,112570,"Some of a variety of methods, non-specific plan",https://columbiacollege.edu/urgent-message-covid-19/,06037,481,Hybrid,89,570
Northwest Louisiana Technical College,160010,"Some of a variety of methods, non-specific plan",https://www.nltcc.edu/community/index,22119,487,Hybrid,85,572
The Christ College of Nursing and Health Sciences,201821,"Some of a variety of methods, non-specific plan",https://www.thechristcollege.edu/COVID19,39061,489,Hybrid,86,575
San Diego Christian College,112084,"Some of a variety of methods, non-specific plan",https://sdcc.edu/coronavirus-covid-19-information/,06073,491,Hybrid,105,596
Kent State University at Geauga,203526,"Some of a variety of methods, non-specific plan",https://www.kent.edu/geauga/covid-19-coronavirus-disease-updates-geauga-campus-and-twinsburg-academic-center,39055,496,Hybrid,108,604
Southwestern Christian University,207856,"Some of a variety of methods, non-specific plan",https://swcu.edu/about/coronavirus,40109,499,Hybrid,84,583
The King's College,454184,"Some of a variety of methods, non-specific plan",https://www.tkc.edu/reopening/,36061,535,Hybrid,86,621
Tabor College,155973,"Some of a variety of methods, non-specific plan",https://tabor.edu/coronavirus/,20115,550,Hybrid,152,702
Oregon State University-Cascades Campus,440828,"Some of a variety of methods, non-specific plan",https://osucascades.edu/covid,41017,557,Hybrid,58,615
Olney Central College,145707,"Some of a variety of methods, non-specific plan",https://my.iecc.edu/students/,17159,560,Hybrid,101,661
Haywood Community College,198668,"Some of a variety of methods, non-specific plan",https://www.haywood.edu/security-and-safety/coronavirus,37087,574,Hybrid,248,822
Boston Architectural College,164872,"Some of a variety of methods, non-specific plan",https://the-bac.edu/about-the-bac/public-safety/coronavirus-update,25025,580,Hybrid,168,748
Louisburg College,198871,"Some of a variety of methods, non-specific plan",https://www.louisburg.edu/news/coronavirus_updates.php,37069,591,Hybrid,117,708
Pennsylvania State University-Penn State Mont Alto,214795,"Some of a variety of methods, non-specific plan",https://virusinfo.psu.edu/,42055,591,Hybrid,0,591
Pennsylvania State University-Penn State Hazleton,214768,"Some of a variety of methods, non-specific plan",https://virusinfo.psu.edu/,42079,592,Hybrid,0,592
Montreat College,199032,"Some of a variety of methods, non-specific plan",https://www.montreat.edu/coronavirus/,37021,603,Hybrid,187,790
Ellsworth Community College,153296,"Some of a variety of methods, non-specific plan",https://www.iavalley.edu/about-the-district/covid-19-updates/,19083,611,Hybrid,75,686
Ohio State University Agricultural Technical Institute,204662,"Some of a variety of methods, non-specific plan",https://ati.osu.edu/futurestudents/covid-19-information-for-new-ohio-state-ati-students,39169,611,Hybrid,85,696
Mayville State University,200226,"Some of a variety of methods, non-specific plan",http://www.mayvillestate.edu/about-msu/fall-2020-covid-19-restart/,38097,613,Hybrid,215,828
Williston State College,200341,"Some of a variety of methods, non-specific plan",https://www.willistonstate.edu/Current-Students/Security-and-Safety/Coronavirus-(COVID-19)-Updates.html,38105,645,Hybrid,94,739
Doane University-Graduate and Professional Studies,448284,"Some of a variety of methods, non-specific plan",https://www.doane.edu/fall-2020,31109,647,Hybrid,0,647
Simpson University,123457,"Some of a variety of methods, non-specific plan",http://simpsonu.edu/Pages/About/Resources/Campus/Coronavirus.html,06089,647,Hybrid,130,777
Western Piedmont Community College,199908,"Some of a variety of methods, non-specific plan",https://www.wpcc.edu/corona-virus/,37023,660,Hybrid,242,902
Labette Community College,155450,"Some of a variety of methods, non-specific plan",http://www.labette.edu/COVID-19.html,20099,661,Hybrid,155,816
Allen University,217624,"Some of a variety of methods, non-specific plan",http://www.allenuniversity.edu/allen-university-and-coronavirus/,45079,688,Hybrid,124,812
Coastal Pines Technical College,485458,"Some of a variety of methods, non-specific plan",http://www.coastalpines.edu/covid-19/,13299,703,Hybrid,244,947
Marshalltown Community College,153922,"Some of a variety of methods, non-specific plan",https://www.iavalley.edu/covid-19-faq/,19127,704,Hybrid,154,858
Galveston College,224961,"Some of a variety of methods, non-specific plan",https://gc.edu/coronavirus-update-thursday-march-19-2020/,48167,711,Hybrid,188,899
Bay de Noc Community College,168883,"Some of a variety of methods, non-specific plan",https://www.baycollege.edu/student-life/health-safety/coronavirus.php,26041,718,Hybrid,159,877
Franciscan Missionaries of Our Lady University,160074,"Some of a variety of methods, non-specific plan",https://franu.edu/online-student-support/information-regarding-coronavirus,22033,721,Hybrid,170,891
Isothermal Community College,198710,"Some of a variety of methods, non-specific plan",https://www.isothermal.edu/coronavirus/index.html,37161,742,Hybrid,247,989
Saint Augustine's University,199582,"Some of a variety of methods, non-specific plan",https://www.st-aug.edu/coronavirus/,37183,750,Hybrid,215,965
Robeson Community College,199476,"Some of a variety of methods, non-specific plan",https://www.robeson.edu/coronavirus-info/,37155,757,Hybrid,230,987
Rust College,176318,"Some of a variety of methods, non-specific plan",https://www.rustcollege.edu/june-covid-19-update/,28093,761,Hybrid,186,947
James A Rhodes State College,203678,"Some of a variety of methods, non-specific plan",http://www.rhodesstate.edu/About%20Rhodes/Coronavirus%20Information%20for%20College%20Community.aspx,39003,764,Hybrid,222,986
College of the Siskiyous,123484,"Some of a variety of methods, non-specific plan",http://www.siskiyous.edu/health/,06093,777,Hybrid,175,952
Ohio University-Zanesville Campus,204866,"Some of a variety of methods, non-specific plan",https://www.ohio.edu/zanesville/coronavirus,39119,781,Hybrid,83,864
Pennsylvania State University-Penn State York,214829,"Some of a variety of methods, non-specific plan",https://virusinfo.psu.edu/,42133,783,Hybrid,0,783
Ripon College,239628,"Some of a variety of methods, non-specific plan",https://www.ripon.edu/coronavirus-information/,55039,788,Hybrid,165,953
Randolph Community College,199421,"Some of a variety of methods, non-specific plan",https://www.randolph.edu/headlines/1470-coronavirus-information-2020.html,37151,789,Hybrid,404,1193
Ohio University-Southern Campus,204839,"Some of a variety of methods, non-specific plan",https://www.ohio.edu/southern/coronavirus,39087,806,Hybrid,87,893
Northwest College,240657,"Some of a variety of methods, non-specific plan",https://www.nwc.edu/a/july-2-covid-19-employee-update-07-2020,56029,811,Hybrid,183,994
Hiram College,203128,"Some of a variety of methods, non-specific plan",https://www.hiram.edu/fall2020/,39133,824,Hybrid,217,1041
Carl Sandburg College,143613,"Some of a variety of methods, non-specific plan",http://www.sandburg.edu/_Emergency/index.html,17095,832,Hybrid,227,1059
Northeastern Junior College,127732,"Some of a variety of methods, non-specific plan",https://www.njc.edu/novel-coronavirus-covid-19,08075,851,Hybrid,167,1018
Ohio State University-Lima Campus,204671,"Some of a variety of methods, non-specific plan",https://lima.osu.edu/ohio-state-lima-coronavirus-information-and-updates.html,39003,851,Hybrid,107,958
University of the Ozarks,107558,"Some of a variety of methods, non-specific plan",https://ozarks.edu/ozarks-coronavirus-update/,05071,861,Hybrid,158,1019
Ohio State University-Mansfield Campus,204680,"Some of a variety of methods, non-specific plan",https://mansfield.osu.edu/ohio-state-mansfield-coronavirus-information-and-updates.html,39139,883,Hybrid,105,988
Middlesex Community College,129756,"Some of a variety of methods, non-specific plan",https://www.middlesex.mass.edu/disclosurestatements/covid_19.aspx,09007,885,Hybrid,154,1039
Cape Cod Community College,165194,"Some of a variety of methods, non-specific plan",https://www.capecod.edu/coronavirus/,25001,887,Hybrid,315,1202
Dickinson State University,200059,"Some of a variety of methods, non-specific plan",https://dsuupdates.com/,38089,902,Hybrid,213,1115
North Georgia Technical College,140678,"Some of a variety of methods, non-specific plan",https://northgatech.edu/communications/coronavirus-info/faqs,13137,908,Hybrid,274,1182
Houghton College,191676,"Some of a variety of methods, non-specific plan",https://www.houghton.edu/coronavirus/,36003,937,Hybrid,213,1150
Warner University,138275,"Some of a variety of methods, non-specific plan",https://www.warner.edu/covid-19-student-updates/,12105,938,Hybrid,179,1117
Ranger College,227687,"Some of a variety of methods, non-specific plan",https://www.rangercollege.edu/covid-19/#1585252822276-283207c9-6a1e,48133,945,Hybrid,186,1131
Wheeling Jesuit University,238078,"Some of a variety of methods, non-specific plan",https://wheeling.edu/coronavirus/,54069,951,Hybrid,175,1126
Lake Michigan College,170620,"Some of a variety of methods, non-specific plan",https://www.lakemichigancollege.edu/about/safety-and-emergency/covid-19,26021,953,Hybrid,256,1209
Danville Area Community College,144564,"Some of a variety of methods, non-specific plan",https://www.dacc.edu/coronavirus,17183,966,Hybrid,225,1191
Bowling Green State University-Firelands,201432,"Some of a variety of methods, non-specific plan",https://www.bgsu.edu/coronavirus.html,39043,986,Hybrid,113,1099
Doane University-Arts & Sciences,181020,"Some of a variety of methods, non-specific plan",https://www.doane.edu/fall-2020,31151,994,Hybrid,406,1400
Iowa Lakes Community College,153533,"Some of a variety of methods, non-specific plan",https://www.iowalakes.edu/covid-19/,19063,994,Hybrid,260,1254
Ohio University-Chillicothe Campus,204820,"Some of a variety of methods, non-specific plan",https://www.ohio.edu/chillicothe/coronavirus,39141,1001,Hybrid,101,1102
Ohio University-Lancaster Campus,204848,"Some of a variety of methods, non-specific plan",https://www.ohio.edu/regional/covid-fall-planning#071020-students,39045,1004,Hybrid,89,1093
Cornell College,153162,"Some of a variety of methods, non-specific plan",,19113,1019,Hybrid,267,1286
Ohio State University-Marion Campus,204699,"Some of a variety of methods, non-specific plan",https://osumarion.osu.edu/features/corona-virus-information.html,39101,1029,Hybrid,135,1164
Mountwest Community and Technical College,444954,"Some of a variety of methods, non-specific plan",http://www.mctc.edu/fall-plans-2020/,54011,1035,Hybrid,145,1180
Nash Community College,199087,"Some of a variety of methods, non-specific plan",https://www.nashccnews.com/news/category/covid-19-updates/,37127,1047,Hybrid,379,1426
Richmond Community College,199449,"Some of a variety of methods, non-specific plan",https://richmondcc.edu/about-us/news/announcement-public-health-restrictions-and-event-rescheduling,37153,1056,Hybrid,256,1312
Marietta College,203845,"Some of a variety of methods, non-specific plan",https://www.marietta.edu/coronavirus-update,39167,1069,Hybrid,380,1449
Florida Memorial University,133979,"Some of a variety of methods, non-specific plan",https://www.fmuniv.edu/coronavirus/,12086,1086,Hybrid,231,1317
Lanier Technical College,140243,"Some of a variety of methods, non-specific plan",https://www.laniertech.edu/coronavirus-covid%e2%80%9119-information-and-resources/,13139,1092,Hybrid,353,1445
Allegany College of Maryland,161688,"Some of a variety of methods, non-specific plan",https://allegany.edu/coronavirus/index.html,24001,1095,Hybrid,357,1452
Illinois Valley Community College,145831,"Some of a variety of methods, non-specific plan",https://www.ivcc.edu/covid19/,17099,1095,Hybrid,239,1334
Honolulu Community College,141680,"Some of a variety of methods, non-specific plan",https://www.honolulu.hawaii.edu/covid19,15003,1125,Hybrid,335,1460
Central Methodist University-College of Liberal Arts and Sciences,176947,"Some of a variety of methods, non-specific plan",https://www.centralmethodist.edu/student-life/services-and-resources/coronavirus-updates.php,29089,1131,Hybrid,252,1383
Livingstone College,198862,"Some of a variety of methods, non-specific plan",https://livingstone.edu/coronavirus-2020/,37159,1139,Hybrid,227,1366
Fletcher Technical Community College,160481,"Some of a variety of methods, non-specific plan",https://www.fletcher.edu/covid19/,22109,1159,Hybrid,141,1300
University of Pittsburgh-Bradford,215266,"Some of a variety of methods, non-specific plan",https://www.upb.pitt.edu/operating-safely-fall,42083,1199,Hybrid,208,1407
Pennsylvania State University-Penn State Brandywine,214731,"Some of a variety of methods, non-specific plan",https://www.brandywine.psu.edu/coronavirus-faq,42045,1208,Hybrid,0,1208
Florida Gateway College,135160,"Some of a variety of methods, non-specific plan",https://www.fgc.edu/coronavirus-covid-19-fgc-update/,12023,1218,Hybrid,248,1466
Saint Martin's University,236452,"Some of a variety of methods, non-specific plan",https://www.stmartin.edu/coronavirus,53067,1238,Hybrid,298,1536
Clark State Community College,201973,"Some of a variety of methods, non-specific plan",https://www.clarkstate.edu/about-us/coronavirus-covid-19-information/,39023,1242,Hybrid,326,1568
Spring Hill College,102234,"Some of a variety of methods, non-specific plan",https://www.shc.edu/academics/badgersback2020/,01097,1249,Hybrid,224,1473
Westmont College,125727,"Some of a variety of methods, non-specific plan",https://www.westmont.edu/covid-19,06083,1266,Hybrid,344,1610
Knox College,146427,"Some of a variety of methods, non-specific plan",https://www.knox.edu/coronavirus-covid-19-information,17095,1310,Hybrid,393,1703
Shaw University,199643,"Some of a variety of methods, non-specific plan",https://www.shawu.edu/Covid-19/,37183,1310,Hybrid,250,1560
Avila University,176628,"Some of a variety of methods, non-specific plan",https://www.avila.edu/healthy-eagles/,29095,1341,Hybrid,250,1591
Reinhardt University,140872,"Some of a variety of methods, non-specific plan",https://www.reinhardt.edu/student-life/student-services-resources/coronavirus-information,13057,1349,Hybrid,243,1592
Northwest-Shoals Community College,101736,"Some of a variety of methods, non-specific plan",https://www.nwscc.edu/coronavirus-covid-19-information,01033,1358,Hybrid,296,1654
Southern Regional Technical College,487162,"Some of a variety of methods, non-specific plan",https://southernregional.edu/coronavirus,13275,1401,Hybrid,406,1807
University of Pittsburgh-Greensburg,215275,"Some of a variety of methods, non-specific plan",https://www.greensburg.pitt.edu/covid-19,42129,1426,Hybrid,189,1615
Elizabeth City State University,198507,"Some of a variety of methods, non-specific plan",https://www.ecsu.edu/coronavirus/,37139,1433,Hybrid,359,1792
West Hills College-Lemoore,448594,"Some of a variety of methods, non-specific plan",https://westhillscollege.com/covid19/,06031,1511,Hybrid,171,1682
Wichita State University-Campus of Applied Sciences and Technology,156107,"Some of a variety of methods, non-specific plan",https://wsutech.edu/covid19-student-faqs/,20173,1528,Hybrid,347,1875
Tunxis Community College,130606,"Some of a variety of methods, non-specific plan",https://www.tunxis.edu/coronavirus-info/,09003,1533,Hybrid,243,1776
University of Maine at Farmington,161226,"Some of a variety of methods, non-specific plan",https://www.umf.maine.edu/about/office-of-the-president/umf-coronavirus-covid-19-communications/,23007,1564,Hybrid,346,1910
Chadron State College,180948,"Some of a variety of methods, non-specific plan",https://www.csc.edu/covid19/index.csc,31045,1598,Hybrid,297,1895
Georgia Northwestern Technical College,139384,"Some of a variety of methods, non-specific plan",https://nwgapublichealth.org/,13115,1635,Hybrid,400,2035
Piedmont Technical College,218520,"Some of a variety of methods, non-specific plan",https://www.ptc.edu/college-resources/campus-police-and-security/covid-19-information,45047,1643,Hybrid,342,1985
Lasell College,166391,"Some of a variety of methods, non-specific plan",https://www.lasell.edu/discover-lasell/news/coronavirus-updates.html,25017,1662,Hybrid,366,2028
Corning Community College,190442,"Some of a variety of methods, non-specific plan",https://www.corning-cc.edu/operating-status.php,36101,1663,Hybrid,256,1919
Caldwell University,183910,"Some of a variety of methods, non-specific plan",https://www.caldwell.edu/coronavirus-update,34013,1664,Hybrid,311,1975
Colorado Mountain College,126711,"Some of a variety of methods, non-specific plan",https://coloradomtn.edu/covid19/,08045,1679,Hybrid,679,2358
Catawba Valley Community College,198233,"Some of a variety of methods, non-specific plan",http://www.cvcc.edu/news/CVCC-Plans-for-Fall-2020-Semester.cfm,37035,1684,Hybrid,510,2194
Northern Oklahoma College,207281,"Some of a variety of methods, non-specific plan",http://www.noc.edu/?Key=Search&q=covid,40071,1693,Hybrid,286,1979
Walla Walla University,236896,"Some of a variety of methods, non-specific plan",https://www.wallawalla.edu/news/covid-19-response-information/,53071,1752,Hybrid,290,2042
Saint Francis University,215743,"Some of a variety of methods, non-specific plan",https://www.francis.edu/coronavirus/,42021,1754,Hybrid,490,2244
Frederick Community College,162557,"Some of a variety of methods, non-specific plan",https://www.frederick.edu/coronavirus-covid19.aspx,24021,1832,Hybrid,648,2480
Augusta Technical College,138956,"Some of a variety of methods, non-specific plan",https://www.augustatech.edu/covid19info2020.cms,13245,1847,Hybrid,308,2155
Louisiana Delta Community College,483212,"Some of a variety of methods, non-specific plan",https://www.ladelta.edu/updates,22073,1883,Hybrid,254,2137
Coppin State University,162283,"Some of a variety of methods, non-specific plan",https://www.coppin.edu/coronavirus,24510,1886,Hybrid,486,2372
Arapahoe Community College,126289,"Some of a variety of methods, non-specific plan",https://www.arapahoe.edu/about-acc/college-leadership/information-about-covid-19,08005,1887,Hybrid,484,2371
John A Logan College,146205,"Some of a variety of methods, non-specific plan",https://www.jalc.edu/covid19,17199,1894,Hybrid,337,2231
University of Dubuque,153278,"Some of a variety of methods, non-specific plan",https://www.dbq.edu/COVID-19/,19061,1905,Hybrid,448,2353
Art Center College of Design,109651,"Some of a variety of methods, non-specific plan",http://www.artcenter.edu/about/get-to-know-artcenter/newsroom/covid-19.html,06037,1952,Hybrid,578,2530
University of St Thomas,227863,"Some of a variety of methods, non-specific plan",https://www.stthom.edu/-ENS/UST-Alerts/Coronavirus.aqf?Aquifer_Source_URL=%2FStayHealthy&PNF_Check=1,48201,1955,Hybrid,453,2408
Kansas City Kansas Community College,155292,"Some of a variety of methods, non-specific plan",https://www.kckcc.edu/communications/covid19/index.html,20209,1962,Hybrid,549,2511
Gwinnett Technical College,140012,"Some of a variety of methods, non-specific plan",https://www.gwinnetttech.edu/emergency-notification/,13135,1964,Hybrid,621,2585
Millikin University,147244,"Some of a variety of methods, non-specific plan",https://millikin.edu/health/coronavirus-and-covid-19/campus-messages,17115,1976,Hybrid,380,2356
Eastern Arizona College,104577,"Some of a variety of methods, non-specific plan",https://www.eac.edu/safety/,04009,1983,Hybrid,400,2383
Indiana University-East,151388,"Some of a variety of methods, non-specific plan",https://coronavirus.iu.edu/,18177,2001,Hybrid,334,2335
Pueblo Community College,127884,"Some of a variety of methods, non-specific plan",https://www.pueblocc.edu/COVID-19/,08101,2014,Hybrid,405,2419
Everglades University,385619,"Some of a variety of methods, non-specific plan",https://www.evergladesuniversity.edu/covid/,12099,2077,Hybrid,252,2329
North Idaho College,142443,"Some of a variety of methods, non-specific plan",https://www.nic.edu/websites/default.aspx?dpt=232&pageId=12953,16055,2080,Hybrid,691,2771
Rose-Hulman Institute of Technology,152318,"Some of a variety of methods, non-specific plan",https://www.rose-hulman.edu/about-us/community-and-public-services/health/index.html,18167,2093,Hybrid,543,2636
University of Arkansas at Monticello,106485,"Some of a variety of methods, non-specific plan",http://www.uamont.edu/pages/coronavirus/,05043,2150,Hybrid,419,2569
McHenry County College,147004,"Some of a variety of methods, non-specific plan",https://www.mchenry.edu/coronavirus/,17111,2169,Hybrid,390,2559
Lake Land College,146506,"Some of a variety of methods, non-specific plan",https://www.lakelandcollege.edu/covid-19/,17029,2190,Hybrid,343,2533
Hobart William Smith Colleges,191630,"Some of a variety of methods, non-specific plan",https://www2.hws.edu/coronavirus-covid-19/,36069,2220,Hybrid,578,2798
Dominican University,148496,"Some of a variety of methods, non-specific plan",https://www.dom.edu/covid-19-alert/home,17031,2315,Hybrid,489,2804
Community College of Denver,126942,"Some of a variety of methods, non-specific plan",https://www.ccd.edu/org/covid-19-updates,08031,2342,Hybrid,407,2749
DeSales University,210739,"Some of a variety of methods, non-specific plan",https://www.desales.edu/inside-desales/emergency-updates,42077,2361,Hybrid,488,2849
Gordon State College,139968,"Some of a variety of methods, non-specific plan",https://www.gordonstate.edu/corona-virus/index.html,13171,2376,Hybrid,300,2676
Mount Saint Mary's University,119173,"Some of a variety of methods, non-specific plan",https://www.msmu.edu/covid-19-information/,06037,2380,Hybrid,539,2919
South Carolina State University,218733,"Some of a variety of methods, non-specific plan",http://reopen.scsucovid19.com/,45075,2402,Hybrid,547,2949
Ohio State University-Newark Campus,204705,"Some of a variety of methods, non-specific plan",https://newark.osu.edu/news/covid-19-updates.html,39089,2462,Hybrid,174,2636
Folsom Lake College,444219,"Some of a variety of methods, non-specific plan",https://flc.losrios.edu/campus-life/news/coronavirus-update,06067,2464,Hybrid,334,2798
Southern Union State Community College,251260,"Some of a variety of methods, non-specific plan",https://www.suscc.edu/covid.cms,01111,2467,Hybrid,315,2782
Owens Community College,204945,"Some of a variety of methods, non-specific plan",https://www.owens.edu/covid19/,39173,2506,Hybrid,655,3161
Stonehill College,167996,"Some of a variety of methods, non-specific plan",https://www.stonehill.edu/news/emergencies/updates/coronavirus/,25005,2513,Hybrid,639,3152
Governors State University,145336,"Some of a variety of methods, non-specific plan",https://www.govst.edu/COVID-19/,17197,2517,Hybrid,757,3274
Iowa Western Community College,153630,"Some of a variety of methods, non-specific plan",https://www.iwcc.edu/covid19/,19155,2555,Hybrid,519,3074
Schoolcraft College,172200,"Some of a variety of methods, non-specific plan",https://schoolcraft.edu/coronavirus,26163,2631,Hybrid,569,3200
Shawnee State University,205443,"Some of a variety of methods, non-specific plan",https://www.shawnee.edu/health,39145,2680,Hybrid,420,3100
Marymount University,232706,"Some of a variety of methods, non-specific plan",https://www.marymount.edu/Student-Life/Health-Wellness/COVID-19-Information?lang=en-US,51013,2686,Hybrid,483,3169
University of South Carolina-Aiken,218645,"Some of a variety of methods, non-specific plan",https://www.usca.edu/pacer-ready,45003,2714,Hybrid,436,3150
Bellarmine University,156286,"Some of a variety of methods, non-specific plan",https://www.bellarmine.edu/coronavirus/,21111,2762,Hybrid,583,3345
Elmhurst College,144962,"Some of a variety of methods, non-specific plan",https://www.elmhurst.edu/covid-19-updates/,17043,2871,Hybrid,537,3408
Southeastern Oklahoma State University,207847,"Some of a variety of methods, non-specific plan",https://www.se.edu/student-wellness/coronavirus-update/,40013,2875,Hybrid,431,3306
Lewis & Clark College,209056,"Some of a variety of methods, non-specific plan",https://www.lclark.edu/news/2020-plans/students/,41051,2939,Hybrid,689,3628
Clark University,165334,"Some of a variety of methods, non-specific plan",https://www.clarku.edu/healthy-clark-covid-plan/,25027,2944,Hybrid,702,3646
Bristol Community College,165033,"Some of a variety of methods, non-specific plan",http://www.bristolcc.edu/studentservices/resources/healthservices/coronavirus/,25005,3051,Hybrid,617,3668
Amarillo College,222576,"Some of a variety of methods, non-specific plan",https://www.actx.edu/COVID19,48375,3236,Hybrid,745,3981
Indiana University-Southeast,151379,"Some of a variety of methods, non-specific plan",https://coronavirus.iu.edu/?_ga=2.45852320.58871468.1594328437-1000961096.1594328437,18043,3277,Hybrid,519,3796
Pennsylvania State University-Penn State Abington,214801,"Some of a variety of methods, non-specific plan",https://www.abington.psu.edu/tags/covid-19,42091,3283,Hybrid,0,3283
Tri-County Technical College,218885,"Some of a variety of methods, non-specific plan",https://tctc.edu/about-us/media-resources/novel-coronavirus-covid-19/,45007,3361,Hybrid,485,3846
Northeast State Community College,221908,"Some of a variety of methods, non-specific plan",https://www.northeaststate.edu/Campus-Life/Health-and-Wellness/Coronavirus/,47163,3411,Hybrid,411,3822
University of the Cumberlands,156541,"Some of a variety of methods, non-specific plan",https://www.ucumberlands.edu/COVID19,21235,3452,Hybrid,692,4144
Nashville State Community College,221184,"Some of a variety of methods, non-specific plan",https://www.nscc.edu/about-nscc/coronavirus-resources,47037,3538,Hybrid,484,4022
Indiana University-South Bend,151342,"Some of a variety of methods, non-specific plan",https://coronavirus.iu.edu/,18141,3717,Hybrid,574,4291
State College of Florida-Manatee-Sarasota,135391,"Some of a variety of methods, non-specific plan",https://www.scf.edu/Administration/PublicSafety/Coronavirus.asp,12081,3807,Hybrid,559,4366
Southeast Community College Area,181640,"Some of a variety of methods, non-specific plan",https://www.southeast.edu/covid-19/,31109,3826,Hybrid,846,4672
Oakland Community College,171535,"Some of a variety of methods, non-specific plan",https://www.oaklandcc.edu/coronavirus/default.aspx,26125,3876,Hybrid,875,4751
Manhattan College,192703,"Some of a variety of methods, non-specific plan",https://manhattan.edu/coronavirus-updates/index.php,36005,3926,Hybrid,704,4630
Madison Area Technical College,238263,"Some of a variety of methods, non-specific plan",https://madisoncollege.edu/coronavirus,55025,3959,Hybrid,1394,5353
Pennsylvania State University-Penn State Erie-Behrend College,214591,"Some of a variety of methods, non-specific plan",https://virusinfo.psu.edu/,42049,4000,Hybrid,0,4000
Minnesota State University Moorhead,174358,"Some of a variety of methods, non-specific plan",https://www.mnstate.edu/emergency/covid-19/,27027,4081,Hybrid,577,4658
Stetson University,137546,"Some of a variety of methods, non-specific plan",https://www.stetson.edu/other/covid-19/,12127,4136,Hybrid,918,5054
Pennsylvania State University-Penn State Harrisburg,214713,"Some of a variety of methods, non-specific plan",https://virusinfo.psu.edu/,42043,4146,Hybrid,0,4146
University of Nebraska at Kearney,181215,"Some of a variety of methods, non-specific plan",https://www.unk.edu/coronavirus/,31019,4212,Hybrid,799,5011
Albany State University,138716,"Some of a variety of methods, non-specific plan",https://www.asurams.edu/student-affairs/health-services/coronavirus.php,13095,4367,Hybrid,682,5049
Winston-Salem State University,199999,"Some of a variety of methods, non-specific plan",https://www.wssu.edu/student-life/university-wellness-center/coronavirus-covid-19.html,37067,4411,Hybrid,863,5274
Trident Technical College,218894,"Some of a variety of methods, non-specific plan",https://www.tridenttech.edu/about/departments/safety/ttc_fluInfo.htm,45019,4614,Hybrid,864,5478
Truman State University,178615,"Some of a variety of methods, non-specific plan",,29001,5024,Hybrid,705,5729
Regis University,127918,"Some of a variety of methods, non-specific plan",https://www.regis.edu/coronavirus/index,08031,5086,Hybrid,949,6035
Barry University,132471,"Some of a variety of methods, non-specific plan",https://www.barry.edu/prepare/,12086,5126,Hybrid,1140,6266
Northeastern State University,207263,"Some of a variety of methods, non-specific plan",https://offices.nsuok.edu/studentaffairs/Coronavirus,40021,5168,Hybrid,890,6058
Kirkwood Community College,153737,"Some of a variety of methods, non-specific plan",https://www.kirkwood.edu/campushealth,19113,5300,Hybrid,1072,6372
Southern University and A & M College,160621,"Some of a variety of methods, non-specific plan",http://www.subr.edu/page/4998,22033,5311,Hybrid,1056,6367
New Jersey City University,185129,"Some of a variety of methods, non-specific plan",https://www.njcu.edu/student-life/campus-services-resources/health-wellness-center/university-communications-covid-19,34017,5448,Hybrid,1081,6529
Illinois Institute of Technology,145725,"Some of a variety of methods, non-specific plan",https://www.iit.edu/COVID-19,17031,5786,Hybrid,1151,6937
Tallahassee Community College,137759,"Some of a variety of methods, non-specific plan",https://www.tcc.fl.edu/about/college/communications-and-marketing/coronavirus-resources/,12073,5922,Hybrid,995,6917
Santa Fe College,137096,"Some of a variety of methods, non-specific plan",https://www.sfcollege.edu/alerts/covid19/student-faqs/index,12001,6035,Hybrid,887,6922
Purdue University Northwest,490805,"Some of a variety of methods, non-specific plan",https://www.pnw.edu/pnw-and-coronavirus-covid-19/safe-return-to-campus/#Experiences,18089,6158,Hybrid,1103,7261
Fort Hays State University,155061,"Some of a variety of methods, non-specific plan",https://www.fhsu.edu/covid-19-response/index,20051,6458,Hybrid,1081,7539
North Carolina Central University,199157,"Some of a variety of methods, non-specific plan",https://www.nccu.edu/coronavirus,37063,6564,Hybrid,1275,7839
CUNY Bronx Community College,190530,"Some of a variety of methods, non-specific plan",http://www.bcc.cuny.edu/covid-19/,36005,6685,Hybrid,1121,7806
University of Southern Indiana,151306,"Some of a variety of methods, non-specific plan",https://www.usi.edu/covid-19/,18163,6728,Hybrid,1124,7852
Augusta University,482149,"Some of a variety of methods, non-specific plan",https://jagwire.augusta.edu/coronavirus/,13245,6840,Hybrid,5440,12280
Hinds Community College,175786,"Some of a variety of methods, non-specific plan",https://www.hindscc.edu/emergency/coronavirus-covid-19,28049,6925,Hybrid,1232,8157
The University of West Florida,138354,"Some of a variety of methods, non-specific plan",https://uwf.edu/coronavirus/,12033,7182,Hybrid,1522,8704
Kutztown University of Pennsylvania,213349,"Some of a variety of methods, non-specific plan",https://www.kutztown.edu/news-and-media/announcements/coronavirus-information-center.html,42011,7232,Hybrid,907,8139
Georgia State University-Perimeter College,244437,"Some of a variety of methods, non-specific plan",https://www.gsu.edu/coronavirus/?utm_source=homepage&utm_medium=menu-cta&utm_campaign=coronavirus,13121,7327,Hybrid,782,8109
Farmingdale State College,196042,"Some of a variety of methods, non-specific plan",https://www.farmingdale.edu/health-wellness-center/coronavirus/index.shtml,36103,7716,Hybrid,1046,8762
Georgia Gwinnett College,447689,"Some of a variety of methods, non-specific plan",https://www.ggc.edu/about-ggc/public-safety/public-health/,13135,8203,Hybrid,966,9169
Stockton University,186876,"Some of a variety of methods, non-specific plan",https://stockton.edu/emergency-management/coronavirus.html,34001,8531,Hybrid,1368,9899
New Jersey Institute of Technology,185828,"Some of a variety of methods, non-specific plan",https://www.njit.edu/pandemicrecovery/,34013,8572,Hybrid,1544,10116
Florida Agricultural and Mechanical University,133650,"Some of a variety of methods, non-specific plan",http://www.famu.edu/index-landing-clean.cfm?coronavirus,12073,8580,Hybrid,1783,10363
University of Colorado Colorado Springs,126580,"Some of a variety of methods, non-specific plan",https://covid19.uccs.edu/,08041,8715,Hybrid,1332,10047
South Dakota State University,219356,"Some of a variety of methods, non-specific plan",https://www.sdstate.edu/covid-19,46011,8727,Hybrid,1799,10526
University of Maine,161253,"Some of a variety of methods, non-specific plan",https://www.maine.edu/together/,23019,8929,Hybrid,2366,11295
University of Northern Colorado,127741,"Some of a variety of methods, non-specific plan",https://www.unco.edu/coronavirus/,08123,9103,Hybrid,1462,10565
Indiana University of Pennsylvania-Main Campus,213020,"Some of a variety of methods, non-specific plan",https://www.iup.edu/news-events/coronavirus-information/,42063,9377,Hybrid,1388,10765
University of North Dakota,200280,"Some of a variety of methods, non-specific plan",http://blogs.und.edu/coronavirus/,38035,9935,Hybrid,2534,12469
University of Rochester,195030,"Some of a variety of methods, non-specific plan",https://www.rochester.edu/coronavirus-update/,36055,9937,Hybrid,8953,18890
Marquette University,239105,"Some of a variety of methods, non-specific plan",https://www.marquette.edu/coronavirus/,55079,10390,Hybrid,2465,12855
New Mexico State University-Main Campus,188030,"Some of a variety of methods, non-specific plan",https://nmsu.edu/coronavirus/#communications,35013,11133,Hybrid,2917,14050
University of North Florida,136172,"Some of a variety of methods, non-specific plan",https://www.unf.edu/publicrelations/news/,12031,11396,Hybrid,1905,13301
University of Vermont,231174,"Some of a variety of methods, non-specific plan",https://www.uvm.edu/returntocampus,50007,11941,Hybrid,3853,15794
Northern Illinois University,147703,"Some of a variety of methods, non-specific plan",https://www.niu.edu/updates/messaging/index.shtml,17037,13184,Hybrid,2928,16112
Bowling Green State University-Main Campus,201441,"Some of a variety of methods, non-specific plan",https://www.bgsu.edu/coronavirus.html,39173,14323,Hybrid,2118,16441
St John's University-New York,195809,"Some of a variety of methods, non-specific plan",https://www.stjohns.edu/life-st-johns/health-and-wellness/student-health-services/coronavirus-disease-2019-covid-19,36081,14521,Hybrid,2045,16566
Middle Tennessee State University,220978,"Some of a variety of methods, non-specific plan",https://www.mtsu.edu/coronavirus/,47149,16231,Hybrid,2323,18554
Utah State University,230728,"Some of a variety of methods, non-specific plan",https://www.usu.edu/covid-19/,49005,18490,Hybrid,3513,22003
Mississippi State University,176080,"Some of a variety of methods, non-specific plan",https://www.msstate.edu/coronavirus,28105,18709,Hybrid,4740,23449
University of Mississippi,176017,"Some of a variety of methods, non-specific plan",https://coronavirus.olemiss.edu/,28071,19864,Hybrid,12535,32399
Grand Valley State University,170082,"Some of a variety of methods, non-specific plan",https://www.gvsu.edu/lakerstogether/,26139,20653,Hybrid,2759,23412
University of Wisconsin-Milwaukee,240453,"Some of a variety of methods, non-specific plan",https://uwm.edu/coronavirus/students/,55079,20821,Hybrid,3157,23978
Georgia Institute of Technology-Main Campus,139755,"Some of a variety of methods, non-specific plan",http://health.gatech.edu/coronavirus#utm_source=gatech_home&utm_medium=banner&utm_campaign=coronavirus_campus,13121,20864,Hybrid,7795,28659
Indiana University-Purdue University-Indianapolis,151111,"Some of a variety of methods, non-specific plan",https://coronavirus.iu.edu/?_ga=2.234065436.326744513.1594327832-473342638.1594327832,18097,22375,Hybrid,8475,30850
Cornell University,190415,"Some of a variety of methods, non-specific plan",https://covid.cornell.edu/,36109,23499,Hybrid,10665,34164
The University of Texas at San Antonio,229027,"Some of a variety of methods, non-specific plan",https://www.utsa.edu/coronavirus/,48029,24415,Hybrid,3579,27994
Kennesaw State University,486840,"Some of a variety of methods, non-specific plan",https://coronavirus.kennesaw.edu/,13067,25125,Hybrid,3652,28777
The University of Tennessee-Knoxville,221759,"Some of a variety of methods, non-specific plan",https://www.utk.edu/coronavirus/,47093,25257,Hybrid,7634,32891
Georgia State University,139940,"Some of a variety of methods, non-specific plan",https://www.gsu.edu/coronavirus/student-information/,13121,26157,Hybrid,5268,31425
University of South Florida-Main Campus,137351,"Some of a variety of methods, non-specific plan",https://www.usf.edu/coronavirus/index.aspx,12057,31546,Hybrid,7939,39485
New York University,193900,"Some of a variety of methods, non-specific plan",https://www.nyu.edu/life/safety-health-wellness/coronavirus-information.html,36061,43140,Hybrid,20715,63855
University of Illinois at Urbana-Champaign,145637,"Some of a variety of methods, non-specific plan",https://covid19.illinois.edu/,17019,43313,Hybrid,11233,54546
University of Michigan-Ann Arbor,170976,"Some of a variety of methods, non-specific plan",https://news.umich.edu/coronavirus/,26161,44340,Hybrid,23142,67482
Pennsylvania State University-Main Campus,214777,"Some of a variety of methods, non-specific plan",https://virusinfo.psu.edu/?utm_source=banner&utm_medium=homeandnews&utm_campaign=virusinfo,42027,45140,Hybrid,22018,67158
Ohio State University-Main Campus,204796,"Some of a variety of methods, non-specific plan",https://safeandhealthy.osu.edu/,39049,53129,Hybrid,32639,85768
Philander Smith College,107600,Hybrid or Hyflex teaching,https://www.philander.edu/academics/covid-19-updates,05119,955,Hybrid,171,1126
Danville Community College,231882,Hybrid or Hyflex teaching,https://danville.edu/coronavirus,51590,987,Hybrid,161,1148
United States Merchant Marine Academy,197027,"Primarily in person, some courses online",https://www.usmma.edu/coronavirus,36059,996,Primarily In Person,258,1254
Carl Albert State College,206923,"Primarily in person, some courses online",https://www.carlalbert.edu/casc-reopening/,40079,1072,Primarily In Person,199,1271
Peninsula College,236258,"Primarily online, some courses in person",https://pencol.edu/news/novel-coronavirus-update,53009,1156,Primarily Online,198,1354
Kishwaukee College,146418,Hybrid or Hyflex teaching,https://www.kish.edu/about-covid-19-response-kish/online-resources-covid-19,17037,1303,Hybrid,249,1552
Coahoma Community College,175519,Fully in person,http://www.coahomacc.edu/coronavirus/,28027,1361,Primarily In Person,235,1596
Virginia Union University,234164,Hybrid or Hyflex teaching,https://www.vuu.edu/coronavirus-2020,51760,1400,Hybrid,287,1687
Cumberland County College,184205,"Primarily online, some courses in person",https://www.rcsj.edu/coronavirus,34011,1431,Primarily Online,230,1661
Savannah Technical College,140942,"Primarily in person, some courses online",https://www.savannahtech.edu/covid/,13051,1440,Primarily In Person,318,1758
River Parishes Community College,436304,"Primarily online, some courses in person",https://www.rpcc.edu/rpcc-response-to-covid-19/,22005,1555,Primarily Online,139,1694
Southwest Mississippi Community College,176354,Fully in person,https://www.smcc.edu/covid-19/notice.php,28113,1602,Primarily In Person,207,1809
Florence-Darlington Technical College,218025,"Primarily online, some courses in person",https://www.fdtc.edu/marketing/news/covid-19-faq,45041,1719,Primarily Online,280,1999
Pierce College-Puyallup,439145,"Fully online, no students on campus",https://www.pierce.ctc.edu/coronavirus,53053,1737,Primarily Online,149,1886
Rogue Community College,209940,Hybrid or Hyflex teaching,https://web.roguecc.edu/risk-management/coronavirus-what-you-should-know,41033,1808,Hybrid,407,2215
Luzerne County Community College,213659,"Primarily in person, some courses online",https://www.luzerne.edu/covidinfo/,42079,2064,Primarily In Person,407,2471
Springfield Technical Community College,167905,"Fully online, at least some students allowed on campus",https://www.stcc.edu/coronavirus/,25013,2112,Primarily Online,511,2623
Fox Valley Technical College,238722,"Primarily in person, some courses online",https://www.fvtc.edu/Coronavirus-COVID-19,55087,2157,Primarily In Person,1053,3210
Rose State College,207670,"Primarily in person, some courses online",https://www.rose.edu/content/about-us/our-campus/covid-19-campus-resource-page/,40109,2651,Primarily In Person,487,3138
East Central University,207041,Hybrid or Hyflex teaching,https://www.ecok.edu/COVID-19,40123,2682,Hybrid,445,3127
Odessa College,227304,"Primarily in person, some courses online",https://www.odessa.edu/current-students/CoronavirusFAQ/index.html,48135,2766,Primarily In Person,434,3200
Laredo College,226134,"Fully online, no students on campus",https://www.laredo.edu/cms/LCC/About_LCC/Coronavirus_Information/,48479,2912,Primarily Online,673,3585
Savannah State University,140960,"Primarily in person, some courses online",https://savannahstate.edu/news/covid-19.shtml,13051,3447,Primarily In Person,532,3979
Southern Arkansas University Main Campus,107983,Hybrid or Hyflex teaching,https://web.saumag.edu/coronavirus,05027,3740,Hybrid,442,4182
